state_name,county_fips,county_name,votes_gop,votes_dem,total_votes,diff,per_gop,per_dem,per_point_diff
Alabama,01001,Autauga County,19764,7450,27639,12314,0.715076522305438,0.26954665508882375,0.4455298672166142
Alabama,01003,Baldwin County,83055,24344,108945,58711,0.7623571526917252,0.22345220065170499,0.5389049520400202
Alabama,01005,Barbour County,5605,4772,10457,833,0.5360045902266425,0.4563450320359568,0.07965955819068571
Alabama,01007,Bibb County,7508,1982,9573,5526,0.7842891465580278,0.20704063511960724,0.5772485114384206
Alabama,01009,Blount County,24595,2627,27459,21968,0.8956990422083834,0.09566990786263156,0.8000291343457518
Alabama,01011,Bullock County,1143,3439,4603,-2296,0.24831631544644797,0.7471214425374756,-0.49880512709102764
Alabama,01013,Butler County,5448,3953,9466,1495,0.5755334882738221,0.41759983097401226,0.15793365729980985
Alabama,01015,Calhoun County,34964,15118,50743,19846,0.6890408529255266,0.2979327197840096,0.39110813314151704
Alabama,01017,Chambers County,8748,6356,15269,2392,0.5729255353985199,0.41626825594341477,0.1566572794551051
Alabama,01019,Cherokee County,10562,1619,12275,8943,0.8604480651731161,0.13189409368635438,0.7285539714867617
Alabama,01021,Chilton County,16052,3056,19260,12996,0.8334371754932502,0.15867082035306335,0.6747663551401869
Alabama,01023,Choctaw County,4294,3126,7461,1168,0.5755260688915695,0.4189786891837555,0.15654737970781402
Alabama,01025,Clarke County,7310,5730,13102,1580,0.5579300870096169,0.43733781102121816,0.12059227598839872
Alabama,01027,Clay County,5589,1262,6913,4327,0.8084767828728483,0.18255460726168088,0.6259221756111675
Alabama,01029,Cleburne County,6472,672,7210,5800,0.8976421636615811,0.09320388349514563,0.8044382801664355
Alabama,01031,Coffee County,16832,5050,22180,11782,0.7588818755635708,0.22768259693417492,0.5311992786293959
Alabama,01033,Colbert County,17311,7057,24668,10254,0.7017593643586834,0.28607913085779146,0.4156802335008919
Alabama,01035,Conecuh County,3435,2951,6419,484,0.5351300825673782,0.45972892973983487,0.07540115282754328
Alabama,01037,Coosa County,3626,1794,5472,1832,0.6626461988304093,0.32785087719298245,0.33479532163742687
Alabama,01039,Covington County,14579,2717,17418,11862,0.8370076931909519,0.15598805833046275,0.6810196348604891
Alabama,01041,Crenshaw County,4864,1700,6617,3164,0.7350763185733716,0.2569140093698051,0.47816230920356656
Alabama,01043,Cullman County,36804,4454,41751,32350,0.8815118200761658,0.10668007951905344,0.7748317405571123
Alabama,01045,Dale County,14281,5154,19699,9127,0.7249606579014163,0.2616376465810447,0.46332301132037157
Alabama,01047,Dallas County,5523,12228,17861,-6705,0.3092212082190247,0.6846201220536364,-0.3753989138346117
Alabama,01049,DeKalb County,24744,4271,29322,20473,0.8438714958051975,0.14565854989427734,0.6982129459109201
Alabama,01051,Elmore County,30089,10304,40891,19785,0.7358342911643149,0.25198698980215695,0.4838473013621579
Alabama,01053,Escambia County,10844,4894,15861,5950,0.6836895529916146,0.3085555765714646,0.37513397642015
Alabama,01055,Etowah County,35343,11487,47460,23856,0.7446902654867257,0.2420353982300885,0.5026548672566372
Alabama,01057,Fayette County,7295,1390,8756,5905,0.8331429876656007,0.1587482868889904,0.6743947007766102
Alabama,01059,Franklin County,10364,2085,12564,8279,0.82489652976759,0.16595033428844316,0.6589461954791468
Alabama,01061,Geneva County,10844,1592,12538,9252,0.8648907321741904,0.12697399904290954,0.7379167331312809
Alabama,01063,Greene County,875,3880,4771,-3005,0.1833997065604695,0.8132466988052819,-0.6298469922448124
Alabama,01065,Hale County,3190,4687,7922,-1497,0.40267609189598585,0.5916435243625348,-0.1889674324665489
Alabama,01067,Henry County,6593,2589,9266,4004,0.7115260090654004,0.27940859054608247,0.43211741851931795
Alabama,01069,Houston County,32384,12738,45750,19646,0.7078469945355191,0.27842622950819673,0.4294207650273224
Alabama,01071,Jackson County,19644,3709,23602,15935,0.8323023472587069,0.1571476993475129,0.675154647911194
Alabama,01073,Jefferson County,138443,180936,324675,-42493,0.4264048664048664,0.5572834372834373,-0.1308785708785709
Alabama,01075,Lamar County,6168,978,7187,5190,0.8582162237373034,0.1360790315848059,0.7221371921524975
Alabama,01077,Lauderdale County,31578,11872,44149,19706,0.7152596887811729,0.2689075630252101,0.4463521257559628
Alabama,01079,Lawrence County,12266,3544,15957,8722,0.7686908566773203,0.2220968853794573,0.546593971297863
Alabama,01081,Lee County,42019,27600,70980,14419,0.5919836573682727,0.3888419273034658,0.20314173006480696
Alabama,01083,Limestone County,34337,13510,48754,20827,0.7042909299749764,0.27710546826927024,0.4271854617057062
Alabama,01085,Lowndes County,1835,4968,6830,-3133,0.2686676427525622,0.7273792093704246,-0.45871156661786233
Alabama,01087,Macon County,1539,7084,8697,-5545,0.17695757157640565,0.8145337472691733,-0.6375761756927676
Alabama,01089,Madison County,102395,86885,193955,15510,0.5279317367430589,0.44796473408780385,0.07996700265525508
Alabama,01091,Marengo County,5337,5476,10882,-139,0.49044293328432276,0.5032163205293144,-0.012773387244991663
Alabama,01093,Marion County,12190,1457,13786,10733,0.8842303786450022,0.10568692876831569,0.7785434498766866
Alabama,01095,Marshall County,33094,5880,39492,27214,0.837992504811101,0.14889091461561835,0.6891015901954827
Alabama,01097,Mobile County,100605,78754,181783,21851,0.5534345895930862,0.43323083016563707,0.12020375942744915
Alabama,01099,Monroe County,6129,4425,10620,1704,0.5771186440677966,0.4166666666666667,0.16045197740112987
Alabama,01101,Montgomery County,33122,64065,98476,-30943,0.3363459116942199,0.6505646045737032,-0.31421869287948334
Alabama,01103,Morgan County,39504,13159,53482,26345,0.7386410381062788,0.24604539845181556,0.49259563965446324
Alabama,01105,Perry County,1336,3849,5215,-2513,0.25618408437200385,0.7380632790028763,-0.4818791946308724
Alabama,01107,Pickens County,5590,4017,9659,1573,0.5787348586810229,0.4158815612382234,0.16285329744279953
Alabama,01109,Pike County,8020,5613,13796,2407,0.5813279211365613,0.40685706001739635,0.17447086111916493
Alabama,01111,Randolph County,8548,2203,10824,6345,0.7897265336289726,0.2035291943828529,0.5861973392461197
Alabama,01113,Russell County,9796,11078,21108,-1282,0.46408944476028047,0.5248247110100436,-0.06073526624976311
Alabama,01115,St. Clair County,36119,7698,44346,28421,0.8144815766923736,0.17358950074414828,0.6408920759482254
Alabama,01117,Shelby County,79428,33036,114439,46392,0.6940640865439229,0.28867781088614897,0.40538627565777396
Alabama,01119,Sumter County,1598,4639,6282,-3041,0.25437758675581024,0.7384590894619548,-0.4840815027061446
Alabama,01121,Talladega County,22210,13092,35591,9118,0.6240341659408277,0.36784580371442216,0.25618836222640556
Alabama,01123,Tallapoosa County,14905,5815,20888,9090,0.7135675986212179,0.2783895059364228,0.43517809268479507
Alabama,01125,Tuscaloosa County,50961,37514,89760,13447,0.5677473262032086,0.41793672014260247,0.1498106060606061
Alabama,01127,Walker County,25947,4826,31106,21121,0.8341477528451102,0.15514691699350608,0.6790008358516042
Alabama,01129,Washington County,6554,2253,8861,4301,0.7396456381898205,0.2542602415077305,0.48538539668209
Alabama,01131,Wilcox County,1826,4036,5884,-2210,0.31033310673011555,0.6859279401767505,-0.37559483344663497
Alabama,01133,Winston County,10187,974,11273,9213,0.9036636210414264,0.08640113545640025,0.8172624855850261
,02901,,2322,1723,4251,599,0.5462244177840508,0.4053163961420842,0.14090802164196664
,02902,,1424,782,2344,642,0.6075085324232082,0.33361774744027306,0.2738907849829352
,02903,,3664,811,4697,2853,0.7800723866297636,0.1726634021715989,0.6074089844581647
,02904,,1718,2243,4134,-525,0.4155781325592646,0.542573778422835,-0.12699564586357043
,02905,,2042,1645,3834,397,0.532603025560772,0.42905581637976004,0.10354720918101196
,02906,,2711,942,3859,1769,0.7025136045607671,0.2441046903342835,0.45840891422648355
,02907,,4239,950,5377,3289,0.7883578203459178,0.17667844522968199,0.6116793751162358
,02908,,2271,512,2866,1759,0.7923935799023029,0.17864619678995114,0.6137473831123517
,02909,,1413,405,1913,1008,0.7386304234187141,0.21170935703084162,0.5269210663878725
,02910,,3835,863,4886,2972,0.7848956201391731,0.17662709783053623,0.6082685223086369
,02911,,3740,1289,5196,2451,0.7197844495765974,0.24807544264819092,0.47170900692840645
,02912,,1773,482,2309,1291,0.7678648765699437,0.2087483759203118,0.5591165006496319
,02913,,2299,752,3229,1547,0.7119851347166305,0.23288943945493962,0.4790956952616909
,02914,,2984,882,4050,2102,0.7367901234567901,0.21777777777777776,0.5190123456790123
,02915,,1207,879,2189,328,0.5513933302878027,0.40155322064869803,0.14984010963910466
,02916,,1721,1196,3057,525,0.5629702322538437,0.3912332351979064,0.17173699705593726
,02917,,1197,1192,2497,5,0.47937525030036043,0.4773728474169003,0.0020024028834601526
,02918,,1293,1576,2966,-283,0.43594066082265676,0.5313553607552259,-0.09541469993256918
,02919,,1236,1332,2683,-96,0.4606783451360417,0.4964591874767052,-0.03578084234066348
,02920,,1242,1697,3050,-455,0.4072131147540984,0.5563934426229509,-0.1491803278688525
,02921,,1657,1565,3364,92,0.49256837098692036,0.46521997621878713,0.027348394768133222
,02922,,3079,1776,5001,1303,0.6156768646270746,0.355128974205159,0.2605478904219156
,02923,,2388,1661,4202,727,0.5683008091385054,0.39528795811518325,0.1730128510233222
,02924,,3454,1831,5442,1623,0.6346931275266446,0.3364571848585079,0.29823594266813674
,02925,,2889,1812,4866,1077,0.593711467324291,0.3723797780517879,0.22133168927250313
,02926,,3301,1724,5188,1577,0.6362760215882807,0.3323053199691596,0.3039707016191211
,02927,,2800,1807,4805,993,0.5827263267429761,0.37606659729448494,0.20665972944849115
,02928,,3306,2150,5610,1156,0.5893048128342246,0.38324420677361853,0.2060606060606061
,02929,,1511,295,1865,1216,0.8101876675603217,0.1581769436997319,0.6520107238605898
,02930,,1334,245,1637,1089,0.8149053145998778,0.14966401954795358,0.6652412950519242
,02931,,2123,616,2856,1507,0.7433473389355743,0.21568627450980393,0.5276610644257703
,02932,,448,233,711,215,0.630098452883263,0.32770745428973275,0.3023909985935303
,02933,,1607,2828,4595,-1221,0.34972796517954297,0.6154515778019587,-0.26572361262241573
,02934,,2668,2480,5360,188,0.49776119402985075,0.4626865671641791,0.03507462686567164
,02935,,787,398,1216,389,0.647203947368421,0.32730263157894735,0.3199013157894737
,02936,,2731,1344,4263,1387,0.6406286652592071,0.31527093596059114,0.325357729298616
,02937,,80,83,173,-3,0.4624277456647399,0.4797687861271676,-0.017341040462427737
,02938,,117,118,249,-1,0.46987951807228917,0.4738955823293173,-0.004016064257028107
,02939,,363,594,1013,-231,0.3583415597235933,0.5863770977295163,-0.22803553800592302
,02940,,25,45,82,-20,0.3048780487804878,0.5487804878048781,-0.2439024390243903
Arizona,04001,Apache County,7491,16574,24333,-9083,0.30785353224016765,0.6811326182550446,-0.3732790860148769
Arizona,04003,Cochise County,31265,21980,54381,9285,0.5749250657398723,0.40418528530185177,0.17073978043802057
Arizona,04005,Coconino County,26519,44103,72110,-17584,0.36775759256691165,0.6116072666759118,-0.24384967410900016
Arizona,04007,Gila County,18375,8943,27726,9432,0.6627353386712833,0.3225492317680156,0.3401861069032677
Arizona,04009,Graham County,10747,4034,15026,6713,0.7152269399707174,0.2684679888193797,0.4467589511513377
Arizona,04011,Greenlee County,2433,1182,3692,1251,0.6589924160346695,0.32015167930660887,0.33884073672806064
Arizona,04012,La Paz County,4542,2050,6677,2492,0.6802456192901003,0.30702411262543056,0.37322150666466974
Arizona,04013,Maricopa County,977495,1023516,2039433,-46021,0.4792974321784535,0.5018630178093617,-0.022565585630908214
Arizona,04015,Mohave County,77724,24687,103836,53037,0.7485265225933202,0.23774991332485843,0.5107766092684618
Arizona,04017,Navajo County,27417,23217,51464,4200,0.5327413337478626,0.45113088761075704,0.08161044613710555
Arizona,04019,Pima County,197183,295049,501058,-97866,0.3935332835719617,0.5888519891908721,-0.1953187056189104
Arizona,04021,Pinal County,92954,67814,163455,25140,0.5686825120063627,0.41487871279557065,0.153803799210792
Arizona,04023,Santa Cruz County,6179,13121,19546,-6942,0.316126061598281,0.6712882431187966,-0.35516218152051565
Arizona,04025,Yavapai County,90280,49111,141719,41169,0.6370352599157487,0.3465378671878859,0.29049739272786285
Arizona,04027,Yuma County,35766,31562,68427,4204,0.5226884124687623,0.4612506759027869,0.0614377365659754
Arkansas,05001,Arkansas County,4301,1813,6284,2488,0.6844366645448758,0.2885105028644176,0.39592616168045824
Arkansas,05003,Ashley County,5540,2119,7911,3421,0.7002907344204272,0.2678548856023259,0.4324358488181013
Arkansas,05005,Baxter County,15810,4625,20968,11185,0.7540061045402519,0.2205742083174361,0.5334318962228157
Arkansas,05007,Benton County,73605,41894,119166,31711,0.6176677911484819,0.35156000872732157,0.26610778242116034
Arkansas,05009,Boone County,13644,3061,17103,10583,0.7977547798631819,0.1789744489270888,0.6187803309360931
Arkansas,05011,Bradley County,2332,1208,3644,1124,0.6399560922063666,0.33150384193194293,0.3084522502744237
Arkansas,05013,Calhoun County,1609,467,2143,1142,0.7508166122258516,0.21791880541297245,0.5328978068128791
Arkansas,05015,Carroll County,7352,3941,11639,3411,0.6316693874044161,0.33860297276398316,0.293066414640433
Arkansas,05017,Chicot County,1750,2252,4093,-502,0.4275592474957244,0.5502076716344979,-0.12264842413877353
Arkansas,05019,Clark County,6432,5341,12235,1091,0.5257049448304045,0.43653453208009807,0.08917041275030646
Arkansas,05021,Clay County,4084,959,5178,3125,0.7887215140981074,0.18520664349169563,0.6035148706064117
Arkansas,05023,Cleburne County,10292,1962,12617,8330,0.8157248157248157,0.15550447808512324,0.6602203376396925
Arkansas,05025,Cleveland County,2857,649,3588,2208,0.7962653288740246,0.18088071348940915,0.6153846153846154
Arkansas,05027,Columbia County,5469,2781,8550,2688,0.6396491228070176,0.32526315789473687,0.3143859649122807
Arkansas,05029,Conway County,5672,2593,8641,3079,0.6564055086216873,0.3000810091424604,0.35632449947922695
Arkansas,05031,Craighead County,25482,11854,38364,13628,0.6642164529246168,0.3089875925346679,0.35522886038994894
Arkansas,05033,Crawford County,18566,4936,24025,13630,0.7727783558792924,0.20545265348595212,0.5673257023933403
Arkansas,05035,Crittenden County,7244,8325,16086,-1081,0.4503294790501057,0.5175307720999627,-0.067201293049857
Arkansas,05037,Cross County,4928,1759,6911,3169,0.7130661264650557,0.25452177687744176,0.458544349587614
Arkansas,05039,Dallas County,1573,963,2649,610,0.5938089845224613,0.3635334088335221,0.23027557568893925
Arkansas,05041,Desha County,1920,2016,4163,-96,0.46120586115781886,0.48426615421570984,-0.02306029305789098
Arkansas,05043,Drew County,4338,2408,6879,1930,0.6306149149585696,0.3500508794882977,0.28056403547027187
Arkansas,05045,Faulkner County,34338,18267,54264,16071,0.6327952233524989,0.33663202122954444,0.2961632021229545
Arkansas,05047,Franklin County,5664,1298,7113,4366,0.7962884858709405,0.18248277801209054,0.6138057078588499
Arkansas,05049,Fulton County,3944,1031,5098,2913,0.7736367202824637,0.2022361710474696,0.5714005492349941
Arkansas,05051,Garland County,29065,14043,44193,15022,0.6576833435159415,0.31776525694114455,0.33991808657479694
Arkansas,05053,Grant County,6791,1268,8197,5523,0.8284738318897158,0.15469074051482248,0.6737830913748933
Arkansas,05055,Greene County,12651,3045,16066,9606,0.7874393128345575,0.18953068592057762,0.5979086269139798
Arkansas,05057,Hempstead County,8067,3294,11835,4773,0.6816223067173638,0.2783269961977186,0.4032953105196452
Arkansas,05059,Hot Spring County,9178,3053,12503,6125,0.7340638246820763,0.24418139646484843,0.4898824282172279
Arkansas,05061,Howard County,3358,1333,4818,2025,0.696969696969697,0.27667081776670815,0.42029887920298886
Arkansas,05063,Independence County,11232,2798,14486,8434,0.7753693221041005,0.19315200883611763,0.5822173132679829
Arkansas,05065,Izard County,4615,1019,5792,3596,0.7967886740331491,0.17593232044198895,0.6208563535911602
Arkansas,05067,Jackson County,3583,1360,5076,2223,0.7058707643814027,0.26792750197005516,0.43794326241134757
Arkansas,05069,Jefferson County,9500,14882,25030,-5382,0.37954454654414704,0.594566520175789,-0.215021973631642
Arkansas,05071,Johnson County,6867,2262,9402,4605,0.7303765156349713,0.24058710912571793,0.4897894065092534
Arkansas,05073,Lafayette County,1730,820,2633,910,0.657045195594379,0.3114318268135207,0.3456133687808583
Arkansas,05075,Lawrence County,4569,1080,5857,3489,0.7800921973706676,0.18439474133515452,0.595697456035513
Arkansas,05077,Lee County,1286,1423,2848,-137,0.4515449438202247,0.4996488764044944,-0.048103932584269704
Arkansas,05079,Lincoln County,2725,1031,3870,1694,0.7041343669250646,0.26640826873385015,0.43772609819121444
Arkansas,05081,Little River County,3714,1226,5178,2488,0.7172653534183082,0.23677095403630746,0.4804943993820008
Arkansas,05083,Logan County,6438,1544,8222,4894,0.7830211627341279,0.18778885915835564,0.5952323035757723
Arkansas,05085,Lonoke County,22884,6684,30660,16200,0.7463796477495107,0.21800391389432486,0.5283757338551859
Arkansas,05087,Madison County,5630,1555,7315,4075,0.7696514012303486,0.21257689678742311,0.5570745044429255
Arkansas,05089,Marion County,5767,1526,7481,4241,0.7708862451543911,0.2039834246758455,0.5669028204785456
Arkansas,05091,Miller County,11907,4235,16506,7672,0.7213740458015268,0.25657336726039015,0.4648006785411366
Arkansas,05093,Mississippi County,7262,4542,12287,2720,0.5910311711565068,0.3696589891755514,0.22137218198095543
Arkansas,05095,Monroe County,1545,1146,2815,399,0.5488454706927176,0.40710479573712255,0.14174067495559506
Arkansas,05097,Montgomery County,3021,722,3839,2299,0.7869236780411566,0.18806980984631413,0.5988538681948424
Arkansas,05099,Nevada County,2133,1076,3358,1057,0.6351995235259082,0.32042882668254913,0.3147706968433591
Arkansas,05101,Newton County,3192,709,3998,2483,0.7983991995997999,0.17733866933466733,0.6210605302651325
Arkansas,05103,Ouachita County,5253,3395,8993,1858,0.5841209829867675,0.3775158456577338,0.20660513732903374
Arkansas,05105,Perry County,3466,1005,4607,2461,0.752333405686998,0.21814629911004993,0.5341871065769481
Arkansas,05107,Phillips County,2393,3561,6155,-1168,0.38878960194963447,0.5785540211210398,-0.18976441917140535
Arkansas,05109,Pike County,3519,644,4246,2875,0.8287800282618936,0.15167216203485634,0.6771078662270372
Arkansas,05111,Poinsett County,5852,1388,7418,4464,0.7888918846050148,0.18711242922620652,0.6017794553788083
Arkansas,05113,Polk County,7018,1242,8468,5776,0.8287671232876712,0.146669815777043,0.6820973075106282
Arkansas,05115,Pope County,18041,5747,24367,12294,0.740386588418763,0.2358517667336972,0.5045348216850658
Arkansas,05117,Prairie County,2764,646,3465,2118,0.7976911976911977,0.18643578643578643,0.6112554112554113
Arkansas,05119,Pulaski County,62389,98855,165468,-36466,0.3770457127662146,0.5974266927744337,-0.2203809800082191
Arkansas,05121,Randolph County,5327,1203,6769,4124,0.7869700103412617,0.17772196779435662,0.6092480425469051
Arkansas,05123,St. Francis County,3221,3571,7054,-350,0.4566203572441168,0.5062375956903884,-0.04961723844627158
Arkansas,05125,Saline County,39519,16042,56903,23477,0.6944976539022547,0.28191835228371087,0.41257930161854384
Arkansas,05127,Scott County,1790,364,2219,1426,0.8066696710229834,0.1640378548895899,0.6426318161333935
Arkansas,05129,Searcy County,3365,587,4018,2778,0.8374813339970134,0.14609258337481335,0.6913887506222001
Arkansas,05131,Sebastian County,31024,14371,46838,16653,0.6623681626030147,0.3068235193646185,0.3555446432383962
Arkansas,05133,Sevier County,3884,1116,5202,2768,0.746635909265667,0.21453287197231835,0.5321030372933486
Arkansas,05135,Sharp County,5923,1392,7544,4531,0.7851272534464475,0.18451749734888653,0.600609756097561
Arkansas,05137,Stone County,4605,1173,5919,3432,0.7780030410542321,0.1981753674607197,0.5798276735935124
Arkansas,05139,Union County,10446,5559,16548,4887,0.6312545322697607,0.33593183466279913,0.29532269760696156
Arkansas,05141,Van Buren County,5962,1566,7704,4396,0.7738836967808931,0.20327102803738317,0.5706126687435099
Arkansas,05143,Washington County,47229,43327,93467,3902,0.5053013363005124,0.4635539816191811,0.04174735468133134
Arkansas,05145,White County,24057,5909,30689,18148,0.7838965101502167,0.19254455994004366,0.591351950210173
Arkansas,05147,Woodruff County,1543,849,2469,694,0.6249493722154719,0.34386391251518833,0.28108545970028354
Arkansas,05149,Yell County,5205,1275,6711,3930,0.775592311130979,0.18998658918194009,0.5856057219490389
California,06001,Alameda County,80504,407954,498082,-327450,0.16162800502728467,0.8190498753217341,-0.6574218702944494
California,06003,Alpine County,238,473,736,-235,0.3233695652173913,0.6426630434782609,-0.31929347826086957
California,06005,Amador County,13503,8095,22234,5408,0.6073131240442565,0.3640820365206441,0.24323108752361244
California,06007,Butte County,46370,48629,97720,-2259,0.47451903397462136,0.49763610315186246,-0.0231170691772411
California,06009,Calaveras County,13275,8804,22506,4471,0.589842708611037,0.39118457300275483,0.19865813560828222
California,06011,Colusa County,4399,3114,7672,1285,0.5733837330552659,0.40589155370177266,0.16749217935349325
California,06013,Contra Costa County,125703,363370,498340,-237667,0.25224344824818395,0.7291608139021551,-0.4769173656539712
California,06015,Del Norte County,6201,4565,11066,1636,0.5603650822338695,0.4125248508946322,0.1478402313392373
California,06017,El Dorado County,60259,50532,113446,9727,0.5311690143328103,0.4454277806180914,0.08574123371471887
California,06019,Fresno County,146741,170694,323722,-23953,0.4532932577952688,0.5272857575326978,-0.073992499737429
California,06021,Glenn County,6139,3315,9639,2824,0.6368917937545389,0.3439153439153439,0.29297644983919496
California,06023,Humboldt County,13756,31010,46222,-17254,0.29760720003461555,0.6708926485223486,-0.3732854484877331
California,06025,Imperial County,10300,25109,36084,-14809,0.2854450726083583,0.6958485755459484,-0.4104035029375901
California,06027,Inyo County,4436,4495,9147,-59,0.48496774898873946,0.491417951240844,-0.00645020225210452
California,06029,Kern County,71254,69278,143486,1976,0.49659200200716447,0.48282062361484746,0.013771378392317013
California,06031,Kings County,23169,17729,41935,5440,0.5524979134374628,0.42277333969238107,0.12972457374508173
California,06033,Lake County,3955,6874,11038,-2919,0.3583076644319623,0.6227577459684726,-0.26445008153651023
California,06035,Lassen County,7722,2596,10484,5126,0.736550934757726,0.24761541396413583,0.4889355207935902
California,06037,Los Angeles County,984383,2609329,3674850,-1624946,0.26787025320761393,0.7100504782508129,-0.442180225043199
California,06039,Madera County,28133,22158,51405,5975,0.5472813928606167,0.43104756346658885,0.11623382939402788
California,06041,Marin County,20505,112921,135667,-92416,0.15114213478590963,0.8323394782813801,-0.6811973434954705
California,06043,Mariposa County,5921,4056,10215,1865,0.579637787567303,0.3970631424375918,0.18257464512971122
California,06045,Mendocino County,6312,18303,25171,-11991,0.2507647689801756,0.7271463191768305,-0.4763815501966549
California,06047,Merced County,28491,36676,66575,-8185,0.4279534359744649,0.5508974840405557,-0.12294404806609083
California,06049,Modoc County,2675,1063,3805,1612,0.7030223390275953,0.2793692509855453,0.42365308804204993
California,06051,Mono County,2433,3884,6511,-1451,0.37367531869144527,0.5965289510059899,-0.22285363231454464
California,06053,Monterey County,34893,93874,131444,-58981,0.26545905480660964,0.7141748577340921,-0.4487158029274824
California,06055,Napa County,11368,32228,44383,-20860,0.2561341054007165,0.7261338800892233,-0.4699997746885068
California,06057,Nevada County,15716,23593,40116,-7877,0.3917638847342706,0.5881194535846046,-0.196355568850334
California,06059,Orange County,630094,761290,1418956,-131196,0.44405464299104414,0.5365141695725589,-0.0924595265815148
California,06061,Placer County,91472,89924,185153,1548,0.49403466322446843,0.48567401014296285,0.008360653081505576
California,06063,Plumas County,6247,4465,10950,1782,0.5705022831050228,0.4077625570776256,0.16273972602739722
California,06065,Riverside County,223443,281657,513358,-58214,0.4352576564502745,0.548656103537882,-0.11339844708760749
California,06067,Sacramento County,151776,287507,448524,-135731,0.33838991893410386,0.6410069472313633,-0.30261702829725945
California,06069,San Benito County,9242,15539,25290,-6297,0.36544088572558325,0.6144325820482404,-0.2489916963226571
California,06071,San Bernardino County,243419,320057,574585,-76638,0.4236431511438691,0.5570228947849317,-0.13337974364106264
California,06073,San Diego County,519950,856502,1405839,-336552,0.3698503171415788,0.6092461512306886,-0.2393958340891098
California,06075,San Francisco County,46296,325099,378512,-278803,0.12231052119879951,0.8588869045102929,-0.7365763833114934
California,06077,San Joaquin County,59346,93016,155165,-33670,0.3824702735797377,0.5994650855540876,-0.21699481197434994
California,06079,San Luis Obispo County,53438,76398,132646,-22960,0.40286175233327803,0.5759540430921399,-0.1730922907588619
California,06081,San Mateo County,54456,225185,284272,-170729,0.19156301007485788,0.7921462542916643,-0.6005832442168064
California,06083,Santa Barbara County,47471,103902,154830,-56431,0.3066007879609895,0.6710714977717497,-0.3644707098107602
California,06085,Santa Clara County,154515,478155,644534,-323640,0.23973134078264297,0.7418615619967294,-0.5021302212140863
California,06087,Santa Cruz County,25485,109745,138638,-84260,0.18382405978158947,0.7915939352846982,-0.6077698755031088
California,06089,Shasta County,57894,28889,88761,29005,0.652245918815696,0.32546951927085094,0.3267763995448451
California,06091,Sierra County,1138,730,1926,408,0.5908618899273105,0.3790238836967809,0.21183800623052956
California,06093,Siskiyou County,12916,9379,22836,3537,0.5655981783149413,0.4107111578209844,0.15488702049395692
California,06095,Solano County,65558,124752,194829,-59194,0.33648994759507056,0.6403153534638067,-0.3038254058687362
California,06097,Sonoma County,40478,153342,197603,-112864,0.20484506814167802,0.7760104856707641,-0.5711654175290861
California,06099,Stanislaus County,79622,84668,168279,-5046,0.47315470141847765,0.5031406176647116,-0.02998591624623398
California,06101,Sutter County,20038,15207,35969,4831,0.5570908282131836,0.4227807278489811,0.1343101003642025
California,06103,Tehama County,13835,7241,21525,6594,0.6427409988385598,0.33639953542392564,0.3063414634146342
California,06105,Trinity County,2513,2383,5095,130,0.4932286555446516,0.4677134445534838,0.025515210991167825
California,06107,Tulare County,65454,56159,124214,9295,0.5269454328819618,0.45211489848165265,0.07483053440030918
California,06109,Tuolumne County,17302,11808,29820,5494,0.5802146210596915,0.3959758551307847,0.18423876592890676
California,06111,Ventura County,135555,216447,358813,-80892,0.37778731539827154,0.6032306521781541,-0.22544333677988254
California,06113,Yolo County,16128,47504,64934,-31376,0.248375273354483,0.731573597807004,-0.48319832445252103
California,06115,Yuba County,10574,7800,18820,2774,0.5618490967056323,0.41445270988310307,0.14739638682252926
Colorado,08001,Adams County,94874,132951,234599,-38077,0.4044092259557799,0.5667159706563114,-0.16230674470053152
Colorado,08003,Alamosa County,3676,3624,7519,52,0.4888947998404043,0.48197898656736265,0.006915813273041638
Colorado,08005,Arapahoe County,126124,211498,346740,-85374,0.36374228528580493,0.609961354328892,-0.24621906904308705
Colorado,08007,Archuleta County,5126,3693,9030,1433,0.5676633444075304,0.4089700996677741,0.15869324473975632
Colorado,08009,Baca County,1840,313,2193,1527,0.8390332877336981,0.14272685818513453,0.6963064295485636
Colorado,08011,Bent County,1468,723,2229,745,0.6585912965455362,0.3243606998654105,0.33423059668012567
Colorado,08013,Boulder County,39289,150247,193709,-110958,0.20282485584046173,0.775632520946368,-0.5728076651059063
Colorado,08014,Broomfield County,16188,28871,46297,-12683,0.34965548523662443,0.6236041212173575,-0.2739486359807331
Colorado,08015,Chaffee County,6180,7112,13620,-932,0.45374449339207046,0.5221732745961821,-0.06842878120411167
Colorado,08017,Cheyenne County,966,127,1105,839,0.8742081447963801,0.11493212669683257,0.7592760180995475
Colorado,08019,Clear Creek County,2618,3495,6290,-877,0.41621621621621624,0.5556438791732909,-0.1394276629570747
Colorado,08021,Conejos County,2269,1936,4291,333,0.5287811698904684,0.45117688184572363,0.07760428804474478
Colorado,08023,Costilla County,713,1279,2031,-566,0.35105859182668636,0.6297390448055146,-0.2786804529788282
Colorado,08025,Crowley County,1262,427,1730,835,0.7294797687861272,0.2468208092485549,0.4826589595375723
Colorado,08027,Custer County,2433,1104,3586,1329,0.6784718349135527,0.3078639152258784,0.37060791968767426
Colorado,08029,Delta County,13013,5862,19272,7151,0.6752283105022832,0.30417185554171855,0.3710564549605646
Colorado,08031,Denver County,59610,283816,350606,-224206,0.17001990838719247,0.8095012635265797,-0.6394813551393872
Colorado,08033,Dolores County,1080,332,1431,748,0.7547169811320755,0.23200559049615654,0.522711390635919
Colorado,08035,Douglas County,120661,104199,230478,16462,0.523525021910985,0.4520995496316351,0.07142547227934992
Colorado,08037,Eagle County,9685,18095,28427,-8410,0.3406972244696943,0.6365427234671264,-0.29584549899743207
Colorado,08039,Elbert County,13722,4395,18554,9327,0.7395709819984909,0.23687614530559448,0.5026948366928965
Colorado,08041,El Paso County,200968,160265,375058,40703,0.5358317913496046,0.42730724314639335,0.10852454820321122
Colorado,08043,Fremont County,17231,7170,25058,10061,0.6876446643786416,0.28613616409928966,0.4015085002793519
Colorado,08045,Garfield County,14404,15070,30274,-666,0.4757878047169188,0.497786879830878,-0.02199907511395921
Colorado,08047,Gilpin County,1815,2199,4143,-384,0.4380883417813179,0.5307748008689356,-0.09268645908761769
Colorado,08049,Grand County,4759,4579,9606,180,0.4954195294607537,0.47668124089110975,0.018738288569643935
Colorado,08051,Gunnison County,3599,6976,10887,-3377,0.3305777532837329,0.6407642142004225,-0.3101864609166896
Colorado,08053,Hinsdale County,353,255,632,98,0.5585443037974683,0.40348101265822783,0.1550632911392405
Colorado,08055,Huerfano County,2193,2071,4389,122,0.49965823650034175,0.47186147186147187,0.027796764638869875
Colorado,08057,Jackson County,680,173,873,507,0.7789232531500573,0.1981672394043528,0.5807560137457045
Colorado,08059,Jefferson County,148043,217891,376430,-69848,0.3932816194245942,0.5788353744388067,-0.1855537550142125
Colorado,08061,Kiowa County,795,98,902,697,0.8813747228381374,0.10864745011086474,0.7727272727272727
Colorado,08063,Kit Carson County,3084,644,3792,2440,0.8132911392405063,0.169831223628692,0.6434599156118144
Colorado,08065,Lake County,1492,2287,3938,-795,0.37887252412392075,0.5807516505840529,-0.20187912646013212
Colorado,08067,La Plata County,14146,20363,35377,-6217,0.3998643186250954,0.5755999660796562,-0.17573564745456083
Colorado,08069,Larimer County,91197,125765,223653,-34568,0.40776112996472214,0.5623219898682333,-0.1545608599035112
Colorado,08071,Las Animas County,4255,3465,7897,790,0.5388122071672787,0.4387742180574902,0.10003798910978856
Colorado,08073,Lincoln County,2118,467,2630,1651,0.8053231939163498,0.17756653992395438,0.6277566539923953
Colorado,08075,Logan County,7987,2201,10411,5786,0.7671693401210259,0.21141100758812795,0.555758332532898
Colorado,08077,Mesa County,53344,30106,85368,23238,0.6248711460968981,0.35266141879861307,0.272209727298285
Colorado,08079,Mineral County,425,317,754,108,0.5636604774535809,0.4204244031830239,0.14323607427055707
Colorado,08081,Moffat County,5627,1186,6964,4441,0.808012636415853,0.17030442274554852,0.6377082136703045
Colorado,08083,Montezuma County,9267,5802,15421,3465,0.6009337915829064,0.3762401919460476,0.2246935996368588
Colorado,08085,Montrose County,16658,7648,24764,9010,0.6726700048457438,0.30883540623485706,0.36383459861088674
Colorado,08087,Morgan County,9407,3741,13415,5666,0.7012299664554603,0.27886693999254564,0.4223630264629147
Colorado,08089,Otero County,5696,3552,9459,2144,0.602177820065546,0.3755153821757057,0.2266624378898403
Colorado,08091,Ouray County,1547,2341,3960,-794,0.39065656565656565,0.5911616161616161,-0.20050505050505046
Colorado,08093,Park County,6864,4786,12032,2078,0.5704787234042553,0.39777260638297873,0.17270611702127658
Colorado,08095,Phillips County,1945,477,2461,1468,0.7903291344981714,0.19382364892320195,0.5965054855749695
Colorado,08097,Pitkin County,2739,8906,11829,-6167,0.23154958153690083,0.7528954264942092,-0.5213458449573083
Colorado,08099,Prowers County,3977,1438,5507,2539,0.7221717813691665,0.2611222080987834,0.4610495732703831
Colorado,08101,Pueblo County,41502,43070,86761,-1568,0.47834856675234266,0.4964212030751144,-0.01807263632277173
Colorado,08103,Rio Blanco County,3047,557,3672,2490,0.8297930283224401,0.1516884531590414,0.6781045751633987
Colorado,08105,Rio Grande County,3645,2488,6280,1157,0.5804140127388535,0.3961783439490446,0.1842356687898089
Colorado,08107,Routt County,5883,10523,16767,-4640,0.35086777598854896,0.6276018369416115,-0.2767340609530626
Colorado,08109,Saguache County,1389,1857,3337,-468,0.41624213365298174,0.5564878633503146,-0.1402457296973329
Colorado,08111,San Juan County,202,342,563,-140,0.35879218472468916,0.6074600355239786,-0.2486678507992895
Colorado,08113,San Miguel County,1081,3890,5057,-2809,0.2137631006525608,0.7692307692307693,-0.5554676685782085
Colorado,08115,Sedgwick County,1120,297,1441,823,0.7772380291464261,0.20610687022900764,0.5711311589174185
Colorado,08117,Summit County,5275,12535,18330,-7260,0.2877795962902346,0.6838516093835243,-0.3960720130932897
Colorado,08119,Teller County,11158,5224,16793,5934,0.6644435181325552,0.31108199845173584,0.35336151968081936
Colorado,08121,Washington County,2537,363,2943,2174,0.8620455317703024,0.12334352701325178,0.7387020047570506
Colorado,08123,Weld County,94965,65169,164791,29796,0.5762754033897483,0.39546455813727693,0.18081084525247132
Colorado,08125,Yuma County,4037,763,4885,3274,0.8264073694984647,0.15619242579324463,0.6702149437052201
Connecticut,09001,Fairfield County,165734,288458,460639,-122724,0.3597915070152549,0.6262127175510541,-0.2664212105357992
Connecticut,09003,Hartford County,157872,279387,444223,-121515,0.3553890726054256,0.628934116423508,-0.2735450438180824
Connecticut,09005,Litchfield County,55618,50138,107541,5480,0.5171794943323942,0.46622218502710594,0.050957309305288245
Connecticut,09007,Middlesex County,40472,56404,98549,-15932,0.41067895158753515,0.5723447219149864,-0.16166577032745127
Connecticut,09009,New Haven County,158068,234322,397744,-76254,0.3974114002976789,0.5891276801158534,-0.19171627981817446
Connecticut,09011,New London County,57071,79395,139493,-22324,0.40913164101424443,0.5691683453650004,-0.16003670435075595
Connecticut,09013,Tolland County,34819,44002,80542,-9183,0.4323086091728539,0.5463236572223188,-0.11401504804946488
Connecticut,09015,Windham County,29193,26721,57151,2472,0.5108047103287782,0.4675508740004549,0.04325383632832325
Delaware,10001,Kent County,40976,44518,86958,-3542,0.47121598932818143,0.511948296878953,-0.04073230755077162
Delaware,10003,New Castle County,87685,194238,286133,-106553,0.3064483998699905,0.6788381626726033,-0.3723897628026128
Delaware,10005,Sussex County,71196,56657,129293,14539,0.5506562613598571,0.4382062447309599,0.1124500166288972
District of Columbia,11001,District of Columbia,1149,29509,31260,-28360,0.03675623800383877,0.9439859245041586,-0.9072296865003199
,11002,,2365,24247,27259,-21882,0.08676033603580469,0.8895043838732162,-0.8027440478374115
,11003,,2972,33584,37377,-30612,0.07951413971158734,0.8985204805094041,-0.8190063407978168
,11004,,1467,35117,37223,-33650,0.03941111678263439,0.9434220777476292,-0.9040109609649948
,11005,,1416,36585,38778,-35169,0.03651555005415442,0.9434473154881634,-0.906931765434009
,11006,,3360,44699,49394,-41339,0.06802445641170993,0.9049479693889946,-0.8369235129772846
,11007,,885,30253,31823,-29368,0.027810074474436727,0.9506646136442196,-0.9228545391697829
,11008,,835,24567,26038,-23732,0.03206851524694677,0.9435056455948998,-0.911437130347953
Florida,12001,Alachua County,50891,89527,142784,-38636,0.35641948677722995,0.6270100291349171,-0.27059054235768715
Florida,12003,Baker County,11911,2037,14082,9874,0.8458315580173271,0.14465274818917767,0.7011788098281495
Florida,12005,Bay County,65993,25538,93025,40455,0.70941144853534,0.27452835259338887,0.4348830959419511
Florida,12007,Bradford County,10334,3160,13650,7174,0.7570695970695971,0.2315018315018315,0.5255677655677655
Florida,12009,Brevard County,207857,148479,360666,59378,0.5763143739637226,0.41168005855833373,0.16463431540538892
Florida,12011,Broward County,333346,618597,957388,-285251,0.34818276393687825,0.6461298867334874,-0.2979471227966091
Florida,12013,Calhoun County,5269,1206,6529,4063,0.8070148567927707,0.18471435135549089,0.6223005054372799
Florida,12015,Charlotte County,73202,42240,116481,30962,0.6284458409526017,0.362634249362557,0.2658115915900447
Florida,12017,Citrus County,65230,27049,93223,38181,0.6997200261737984,0.2901537174302479,0.40956630874355043
Florida,12019,Clay County,84422,38248,124522,46174,0.6779685517418609,0.3071585743884615,0.3708099773533994
Florida,12021,Collier County,128936,77595,208238,51341,0.6191761349993757,0.3726265138927573,0.24654962110661843
Florida,12023,Columbia County,23835,8912,33039,14923,0.7214201398347407,0.2697418202730107,0.45167831956173005
Florida,12027,DeSoto County,8313,4259,12676,4054,0.655806248027769,0.33598927106342696,0.319816976964342
Florida,12029,Dixie County,6757,1364,8170,5393,0.8270501835985312,0.16695226438188496,0.6600979192166463
Florida,12031,Duval County,233687,252450,492556,-18763,0.4744374243740813,0.5125305549013717,-0.03809313052729035
Florida,12033,Escambia County,96655,70893,170311,25762,0.5675205946767972,0.41625614317337106,0.1512644515034261
Florida,12035,Flagler County,42991,28124,71773,14867,0.5989856909980076,0.3918465160993688,0.20713917489863876
Florida,12037,Franklin County,4675,2118,6857,2557,0.6817850371882748,0.30888143502989646,0.3729036021583783
Florida,12039,Gadsden County,7461,16139,23783,-8678,0.3137114745826851,0.6785939536643821,-0.364882479081697
Florida,12041,Gilchrist County,7895,1700,9685,6195,0.8151781104801239,0.17552916881775943,0.6396489416623645
Florida,12043,Glades County,3781,1384,5201,2397,0.7269755816189194,0.26610267256296866,0.46087290905595074
Florida,12045,Gulf County,6111,1985,8170,4126,0.7479804161566708,0.24296205630354958,0.5050183598531212
Florida,12047,Hamilton County,3811,1959,5832,1852,0.6534636488340192,0.3359053497942387,0.3175582990397805
Florida,12049,Hardee County,6122,2298,8493,3824,0.7208289179324149,0.2705757682797598,0.45025314965265506
Florida,12051,Hendry County,7898,4925,12944,2973,0.6101668726823238,0.3804851668726823,0.22968170580964153
Florida,12053,Hernando County,70321,37446,109176,32875,0.6441067633912215,0.34298746977357664,0.3011192936176449
Florida,12055,Highlands County,34846,16917,52193,17929,0.6676374226428832,0.324123924664227,0.34351349797865616
Florida,12057,Hillsborough County,327306,376196,713785,-48890,0.4585498434402516,0.5270438577442788,-0.06849401430402713
Florida,12059,Holmes County,8074,924,9072,7150,0.8899911816578483,0.10185185185185185,0.7881393298059964
Florida,12061,Indian River County,58797,37801,97619,20996,0.6023110255175734,0.38722994499021707,0.21508108052735636
Florida,12063,Jackson County,15488,6766,22419,8722,0.6908425888755074,0.3017975824077791,0.3890450064677283
Florida,12065,Jefferson County,4474,3893,8459,581,0.5289041257831895,0.4602198841470623,0.06868424163612719
Florida,12067,Lafayette County,3126,507,3657,2619,0.8547990155865464,0.13863822805578344,0.716160787530763
Florida,12069,Lake County,125687,83273,211314,42414,0.5947878512545312,0.3940723283833537,0.20071552287117744
Florida,12071,Lee County,233242,157672,394687,75570,0.5909543511694076,0.3994861751210453,0.19146817604836236
Florida,12073,Leon County,57446,103492,162895,-46046,0.35265661929463765,0.6353295067374689,-0.28267288744283126
Florida,12075,Levy County,16721,6189,23140,10532,0.7226015557476232,0.2674589455488332,0.45514261019879
Florida,12077,Liberty County,2846,693,3562,2153,0.7989893318360471,0.19455362156092082,0.6044357102751263
Florida,12079,Madison County,5576,3747,9380,1829,0.594456289978678,0.39946695095948825,0.1949893390191898
Florida,12081,Manatee County,124966,90127,217387,34839,0.5748549821286462,0.4145924089296968,0.16026257319894938
Florida,12083,Marion County,127744,74802,204577,52942,0.6244299212521447,0.3656422765022461,0.25878764474989857
Florida,12085,Martin County,61133,36873,98887,24260,0.6182106849231952,0.3728801561378139,0.2453305287853813
Florida,12086,Miami-Dade County,532734,617647,1158600,-84913,0.45980838943552566,0.5330977041256689,-0.07328931469014327
Florida,12087,Monroe County,25668,21848,48074,3820,0.5339268627532554,0.4544660315347173,0.07946083121853809
Florida,12089,Nassau County,42502,15542,58828,26960,0.7224790915890392,0.2641939212619841,0.4582851703270551
Florida,12091,Okaloosa County,79633,34165,116485,45468,0.6836330858050392,0.29329956646778554,0.3903335193372537
Florida,12093,Okeechobee County,11460,4380,15964,7080,0.7178651966925582,0.27436732648459033,0.4434978702079679
Florida,12095,Orange County,245325,394857,648829,-149532,0.3781042462651947,0.6085686675533923,-0.23046442128819766
Florida,12097,Osceola County,73467,97278,172999,-23811,0.4246671946080613,0.5623038283458286,-0.1376366337377673
Florida,12099,Palm Beach County,334642,433392,774243,-98750,0.432218308722197,0.5597622451865887,-0.12754393646439166
Florida,12101,Pasco County,179545,118918,301734,60627,0.5950439791339391,0.394115346629813,0.20092863250412613
Florida,12103,Pinellas County,275949,277191,560668,-1242,0.49217897222598755,0.4943941869341571,-0.002215214708169544
Florida,12105,Polk County,194271,144775,343423,49496,0.5656901255885599,0.421564659326836,0.1441254662617239
Florida,12107,Putnam County,25496,10512,36384,14984,0.7007475813544415,0.28891820580474936,0.4118293755496921
Florida,12109,St. Johns County,110886,63808,176942,47078,0.6266799290162878,0.36061534288071795,0.2660645861355698
Florida,12111,St. Lucie County,86825,84115,172320,2710,0.5038590993500465,0.4881325441039926,0.015726555246053875
Florida,12113,Santa Rosa County,77349,27582,106857,49767,0.7238552457957832,0.2581206659367192,0.465734579859064
Florida,12115,Sarasota County,148065,119892,270656,28173,0.5470597363442894,0.44296819579096713,0.10409154055332226
Florida,12117,Seminole County,125217,132486,261458,-7269,0.47891822013478264,0.5067200085673416,-0.027801788432558927
Florida,12119,Sumter County,62753,29326,92600,33427,0.6776781857451404,0.31669546436285095,0.36098272138228943
Florida,12121,Suwannee County,16410,4485,21082,11925,0.7783891471397401,0.21274072668627264,0.5656484204534674
Florida,12123,Taylor County,7748,2299,10135,5449,0.7644795263936852,0.2268376911692156,0.5376418352244696
Florida,12125,Union County,5130,1052,6247,4078,0.8211941732031375,0.16840083239955178,0.6527933408035858
Florida,12127,Volusia County,173797,130541,307981,43256,0.5643107854055932,0.42386056282692763,0.14045022257866557
Florida,12129,Wakulla County,12868,5346,18435,7522,0.6980200705180364,0.2899918633034988,0.4080282072145376
Florida,12131,Walton County,32942,10336,43704,22606,0.7537525169320886,0.23650009152480322,0.5172524254072853
Florida,12133,Washington County,9876,2347,12335,7529,0.8006485610052696,0.19027158492095664,0.610376976084313
Georgia,13001,Appling County,6526,1779,8341,4747,0.7824001918235224,0.21328377892339048,0.5691164129001319
Georgia,13003,Atkinson County,2300,825,3155,1475,0.7290015847860539,0.26148969889064977,0.46751188589540416
Georgia,13005,Bacon County,4018,625,4668,3393,0.8607540702656384,0.13389031705227078,0.7268637532133677
Georgia,13007,Baker County,897,652,1555,245,0.5768488745980708,0.4192926045016077,0.15755627009646306
Georgia,13009,Baldwin County,8903,9140,18251,-237,0.48780888718426385,0.500794477014958,-0.0129855898306942
Georgia,13011,Banks County,7795,932,8813,6863,0.8844888233291728,0.1057528650856689,0.7787359582435038
Georgia,13013,Barrow County,26804,10453,38017,16351,0.7050530026040982,0.27495594076334273,0.43009706184075547
Georgia,13015,Bartow County,37673,12091,50466,25582,0.746502595807078,0.2395870487060595,0.5069155471010185
Georgia,13017,Ben Hill County,4110,2392,6560,1718,0.6265243902439024,0.3646341463414634,0.261890243902439
Georgia,13019,Berrien County,6409,1268,7731,5141,0.8290001293493726,0.16401500452722803,0.6649851248221446
Georgia,13021,Bibb County,26506,43234,70623,-16728,0.3753168231312745,0.6121801679339592,-0.23686334480268473
Georgia,13023,Bleckley County,4328,1311,5706,3017,0.7584998247458815,0.22975814931650893,0.5287416754293726
Georgia,13025,Brantley County,6991,699,7746,6292,0.9025303382390911,0.09024012393493416,0.8122902143041569
Georgia,13027,Brooks County,4260,2790,7100,1470,0.6,0.3929577464788732,0.20704225352112676
Georgia,13029,Bryan County,14244,6739,21340,7505,0.6674789128397376,0.31579194001874417,0.3516869728209934
Georgia,13031,Bulloch County,18386,11243,30084,7143,0.6111554314585826,0.37372024996675973,0.2374351814918229
Georgia,13033,Burke County,5400,5209,10684,191,0.5054286783976039,0.48755147884687383,0.017877199550730027
Georgia,13035,Butts County,8403,3271,11786,5132,0.7129645341931105,0.27753266587476666,0.4354318683183438
Georgia,13037,Calhoun County,923,1259,2193,-336,0.4208846329229366,0.5740994072047424,-0.1532147742818058
Georgia,13039,Camden County,15251,7967,23688,7284,0.6438280986153326,0.3363306315433975,0.30749746707193515
Georgia,13043,Candler County,3129,1258,4420,1871,0.7079185520361991,0.2846153846153846,0.42330316742081453
Georgia,13045,Carroll County,37476,16238,54474,21238,0.6879612292102655,0.29808716084737674,0.38987406836288874
Georgia,13047,Catoosa County,25167,6932,32692,18235,0.7698213630245931,0.2120396427260492,0.557781720298544
Georgia,13049,Charlton County,3419,1102,4565,2317,0.7489594742606791,0.24140197152245346,0.5075575027382256
Georgia,13051,Chatham County,53191,78181,133289,-24990,0.39906518917540085,0.586552528715798,-0.18748733954039715
Georgia,13053,Chattahoochee County,880,667,1590,213,0.5534591194968553,0.41949685534591197,0.13396226415094337
Georgia,13055,Chattooga County,8064,1854,10050,6210,0.8023880597014925,0.18447761194029852,0.617910447761194
Georgia,13057,Cherokee County,99474,42683,144598,56791,0.6879348262078314,0.2951838891270972,0.3927509370807342
Georgia,13059,Clarke County,14412,35969,51218,-21557,0.28138545042758406,0.7022726385255184,-0.4208871880979343
Georgia,13061,Clay County,637,790,1434,-153,0.44421199442119946,0.5509065550906556,-0.1066945606694561
Georgia,13063,Clayton County,15671,94365,111077,-78694,0.14108231226986684,0.8495458105638432,-0.7084634982939764
Georgia,13065,Clinch County,2105,747,2864,1358,0.734986033519553,0.2608240223463687,0.47416201117318435
Georgia,13067,Cobb County,164965,221234,392614,-56269,0.42017095671575644,0.563489839893636,-0.14331888317787955
Georgia,13069,Coffee County,10532,4463,15142,6069,0.6955488046493198,0.2947430986659622,0.4008057059833576
Georgia,13071,Colquitt County,11776,4185,16080,7591,0.7323383084577114,0.26026119402985076,0.47207711442786066
Georgia,13073,Columbia County,49952,29175,80454,20777,0.6208765257165585,0.3626295771496756,0.2582469485668829
Georgia,13075,Cook County,4900,2059,7035,2841,0.6965174129353234,0.29267945984363897,0.40383795309168447
Georgia,13077,Coweta County,51501,24210,76799,27291,0.6705946692014219,0.315238479667704,0.35535618953371784
Georgia,13079,Crawford County,4428,1615,6102,2813,0.7256637168141593,0.2646673221894461,0.4609963946247132
Georgia,13081,Crisp County,4987,2986,8052,2001,0.6193492300049677,0.3708395429706905,0.24850968703427717
Georgia,13083,Dade County,6066,1261,7434,4805,0.8159806295399515,0.16962604250739843,0.6463545870325531
Georgia,13085,Dawson County,13393,2486,16075,10907,0.8331570762052877,0.15465007776049766,0.67850699844479
Georgia,13087,Decatur County,6758,4780,11627,1978,0.5812333362002237,0.4111120667412058,0.17012126945901784
Georgia,13089,DeKalb County,57993,305197,367359,-247204,0.1578646501106547,0.8307867780563427,-0.6729221279456881
Georgia,13091,Dodge County,5839,2170,8064,3669,0.7240823412698413,0.2690972222222222,0.45498511904761907
Georgia,13093,Dooly County,2159,1911,4105,248,0.5259439707673569,0.46552984165651645,0.06041412911084043
Georgia,13095,Dougherty County,10446,24540,35266,-14094,0.2962059774286849,0.6958543639766347,-0.3996483865479498
Georgia,13097,Douglas County,25308,42609,68745,-17301,0.36814313768274054,0.6198123499890901,-0.25166921230634953
Georgia,13099,Early County,2719,2437,5184,282,0.5244984567901234,0.47010030864197533,0.054398148148148084
Georgia,13101,Echols County,1256,167,1441,1089,0.871616932685635,0.11589174184594032,0.7557251908396947
Georgia,13103,Effingham County,23357,7720,31624,15637,0.7385846192764989,0.24411839109537062,0.4944662281811283
Georgia,13105,Elbert County,6226,2879,9171,3347,0.6788790753462,0.31392432668193215,0.3649547486642678
Georgia,13107,Emanuel County,6551,2884,9501,3667,0.6895063677507631,0.3035469950531523,0.3859593726976108
Georgia,13109,Evans County,2888,1324,4247,1564,0.6800094184129974,0.3117494702142689,0.36825994819872854
Georgia,13111,Fannin County,12144,2571,14825,9573,0.8191568296795952,0.17342327150084316,0.6457335581787521
Georgia,13113,Fayette County,36316,31863,69110,4453,0.5254811170597598,0.4610476052669657,0.06443351179279405
Georgia,13115,Floyd County,27059,10959,38514,16100,0.7025756867632549,0.2845458794204705,0.4180298073427844
Georgia,13117,Forsyth County,85081,42177,129237,42904,0.6583331398902791,0.32635390793658164,0.33197923195369744
Georgia,13119,Franklin County,9069,1593,10786,7476,0.8408121639161876,0.14769145188206934,0.6931207120341183
Georgia,13121,Fulton County,136140,377484,519804,-241344,0.2619064108779463,0.7262044924625436,-0.4642980815845973
Georgia,13123,Gilmer County,13382,2905,16450,10477,0.8134954407294833,0.17659574468085107,0.6368996960486323
Georgia,13125,Glascock County,1403,155,1566,1248,0.8959131545338442,0.09897828863346105,0.7969348659003832
Georgia,13127,Glynn County,25616,15879,41984,9737,0.6101371951219512,0.3782155106707317,0.23192168445121947
Georgia,13129,Gordon County,19405,4384,24033,15021,0.8074314484250822,0.18241584487995674,0.6250156035451254
Georgia,13131,Grady County,7027,3608,10689,3419,0.6574048086818224,0.3375432687809898,0.3198615399008326
Georgia,13133,Greene County,7068,4088,11250,2980,0.6282666666666666,0.3633777777777778,0.26488888888888884
Georgia,13135,Gwinnett County,166016,241140,412757,-75124,0.4022124397648011,0.5842178327684328,-0.18200539300363167
Georgia,13137,Habersham County,16616,3559,20407,13057,0.8142304111334346,0.17440094085362864,0.639829470279806
Georgia,13139,Hall County,64105,25002,90424,39103,0.7089378925948863,0.2764973900734318,0.43244050252145444
Georgia,13141,Hancock County,1159,2985,4165,-1826,0.27827130852340937,0.7166866746698679,-0.43841536614645854
Georgia,13143,Haralson County,12331,1792,14272,10539,0.8639994394618834,0.12556053811659193,0.7384389013452914
Georgia,13145,Harris County,14319,5457,20040,8862,0.7145209580838323,0.2723053892215569,0.4422155688622754
Georgia,13147,Hart County,9464,3157,12727,6307,0.7436159346271706,0.2480553154710458,0.49556061915612476
Georgia,13149,Heard County,4516,824,5397,3692,0.8367611636094127,0.1526774133778025,0.6840837502316102
Georgia,13151,Henry County,48187,73276,122742,-25089,0.3925877042903,0.596992064655945,-0.20440436036564502
Georgia,13153,Houston County,41534,32232,74947,9302,0.5541782859887654,0.43006391183102727,0.12411437415773813
Georgia,13155,Irwin County,3134,1008,4171,2126,0.7513785662910573,0.24166866458882763,0.5097099017022296
Georgia,13157,Jackson County,29497,7642,37670,21855,0.7830368993894345,0.20286700292009557,0.5801698964693389
Georgia,13159,Jasper County,5822,1761,7644,4061,0.7616431187859759,0.23037676609105182,0.5312663526949241
Georgia,13161,Jeff Davis County,4695,1028,5774,3667,0.8131278143401455,0.1780394873571181,0.6350883269830274
Georgia,13163,Jefferson County,3537,4061,7652,-524,0.4622320961840042,0.5307109252483011,-0.06847882906429692
Georgia,13165,Jenkins County,2161,1266,3455,895,0.6254703328509407,0.36642547033285094,0.2590448625180897
Georgia,13167,Johnson County,2850,1222,4100,1628,0.6951219512195121,0.29804878048780487,0.3970731707317073
Georgia,13169,Jones County,9965,4888,14966,5077,0.6658425765067486,0.32660697581184017,0.33923560069490843
Georgia,13171,Lamar County,6322,2612,9045,3710,0.6989496959646213,0.28877833056937535,0.41017136539524596
Georgia,13173,Lanier County,2509,1019,3576,1490,0.7016219239373602,0.2849552572706935,0.41666666666666674
Georgia,13175,Laurens County,14479,8048,22690,6431,0.6381225209343323,0.35469369766416925,0.28342882327016305
Georgia,13177,Lee County,12007,4558,16714,7449,0.7183798013641259,0.27270551633361256,0.4456742850305134
Georgia,13179,Liberty County,7944,13051,21326,-5107,0.37250304792272343,0.6119759917471631,-0.23947294382443968
Georgia,13181,Lincoln County,3175,1432,4643,1743,0.6838251130734438,0.30842127934525093,0.3754038337281929
Georgia,13183,Long County,3528,2033,5656,1495,0.6237623762376238,0.35944130127298446,0.2643210749646393
Georgia,13185,Lowndes County,25691,20117,46355,5574,0.5542228454319922,0.43397691726890303,0.12024592816308916
Georgia,13187,Lumpkin County,12160,3122,15524,9038,0.7833032723524864,0.2011079618654986,0.5821953104869878
Georgia,13189,McDuffie County,6169,4168,10456,2001,0.5899961744452946,0.39862280030604436,0.19137337413925026
Georgia,13191,McIntosh County,4016,2612,6700,1404,0.5994029850746269,0.38985074626865673,0.20955223880597013
Georgia,13193,Macon County,1783,2857,4662,-1074,0.38245388245388245,0.6128271128271128,-0.23037323037323032
Georgia,13195,Madison County,11146,3365,14707,7781,0.7578704018494594,0.22880261100156388,0.5290677908478956
Georgia,13197,Marion County,2275,1311,3624,964,0.6277593818984547,0.3617549668874172,0.2660044150110375
Georgia,13199,Meriwether County,6524,4287,10877,2237,0.5997977383469707,0.3941344120621495,0.2056633262848212
Georgia,13201,Miller County,2066,749,2835,1317,0.7287477954144621,0.2641975308641975,0.4645502645502646
Georgia,13205,Mitchell County,4935,3995,8963,940,0.5505968983599241,0.4457212986723195,0.10487559968760457
Georgia,13207,Monroe County,11060,4384,15592,6676,0.7093381221139046,0.28116983068240126,0.4281682914315033
Georgia,13209,Montgomery County,2959,976,3962,1983,0.7468450277637557,0.24634023220595658,0.5005047955577991
Georgia,13211,Morgan County,8228,3355,11705,4873,0.702947458351132,0.2866296454506621,0.41631781290046993
Georgia,13213,Murray County,12943,2302,15389,10641,0.8410552992397167,0.14958736760023394,0.6914679316394827
Georgia,13215,Muscogee County,30018,49425,80516,-19407,0.37282030900690544,0.6138531472005564,-0.24103283819365096
Georgia,13217,Newton County,23867,29781,54224,-5914,0.4401556506344054,0.5492217468279729,-0.10906609619356744
Georgia,13219,Oconee County,16594,8160,25165,8434,0.6594079078084641,0.32425988476058015,0.335148023047884
Georgia,13221,Oglethorpe County,5591,2435,8126,3156,0.6880383952744278,0.2996554270243662,0.3883829682500616
Georgia,13223,Paulding County,54460,29658,85273,24802,0.6386546738123439,0.34780059338829405,0.2908540804240498
Georgia,13225,Peach County,6502,5920,12546,582,0.5182528295871194,0.4718635421648334,0.046389287422285985
Georgia,13227,Pickens County,14075,2808,17116,11267,0.8223299836410376,0.16405702266884786,0.6582729609721898
Georgia,13229,Pierce County,7899,1099,9047,6800,0.8731071073283961,0.12147673261854758,0.7516303747098485
Georgia,13231,Pike County,9124,1503,10715,7621,0.8515165655622958,0.14027064862342511,0.7112459169388707
Georgia,13233,Polk County,13589,3658,17399,9931,0.781021897810219,0.21024196792919134,0.5707799298810277
Georgia,13235,Pulaski County,2805,1217,4059,1588,0.6910569105691057,0.29982754372998277,0.3912293668391229
Georgia,13237,Putnam County,8291,3448,11855,4843,0.699367355546183,0.2908477435681147,0.4085196119780683
Georgia,13239,Quitman County,604,497,1106,107,0.546112115732369,0.44936708860759494,0.09674502712477401
Georgia,13241,Rabun County,7474,1984,9587,5490,0.7795973714404923,0.20694690727026183,0.5726504641702306
Georgia,13243,Randolph County,1391,1671,3074,-280,0.4525048796356539,0.5435914118412492,-0.09108653220559526
Georgia,13245,Richmond County,26707,58776,86584,-32069,0.3084519079737596,0.6788321167883211,-0.3703802088145615
Georgia,13247,Rockdale County,12990,31199,44617,-18209,0.291144630970258,0.6992626129053948,-0.4081179819351368
Georgia,13249,Schley County,1800,462,2275,1338,0.7912087912087912,0.20307692307692307,0.5881318681318681
Georgia,13251,Screven County,3915,2661,6641,1254,0.5895196506550219,0.4006926667670532,0.1888269838879687
Georgia,13253,Seminole County,2607,1251,3877,1356,0.6724271343822543,0.322672169202992,0.3497549651792623
Georgia,13255,Spalding County,18057,11784,30161,6273,0.5986870461854713,0.3907032260203574,0.2079838201651139
Georgia,13257,Stephens County,9368,2385,11885,6983,0.7882204459402609,0.20067311737484222,0.5875473285654187
Georgia,13259,Stewart County,801,1182,1990,-381,0.40251256281407033,0.5939698492462312,-0.19145728643216087
Georgia,13261,Sumter County,5732,6318,12150,-586,0.4717695473251029,0.52,-0.04823045267489712
Georgia,13263,Talbot County,1390,2113,3519,-723,0.39499857914180164,0.6004546746234726,-0.20545609548167093
Georgia,13265,Taliaferro County,360,561,928,-201,0.3879310344827586,0.6045258620689655,-0.2165948275862069
Georgia,13267,Tattnall County,6048,2059,8175,3989,0.7398165137614678,0.25186544342507644,0.4879510703363914
Georgia,13269,Taylor County,2418,1387,3839,1031,0.6298515238343319,0.361292003125814,0.26855952070851785
Georgia,13271,Telfair County,2822,1480,4323,1342,0.6527874161461947,0.3423548461716401,0.31043256997455465
Georgia,13273,Terrell County,2004,2376,4417,-372,0.45370160742585464,0.5379216662893367,-0.08422005886348205
Georgia,13275,Thomas County,12954,8708,21853,4246,0.5927790234750377,0.39848075779069236,0.19429826568434538
Georgia,13277,Tift County,10784,5322,16284,5462,0.6622451486121346,0.3268238761974945,0.3354212724146401
Georgia,13279,Toombs County,7872,2939,10914,4933,0.7212754260582738,0.269287154113982,0.45198827194429175
Georgia,13281,Towns County,6384,1550,7979,4834,0.800100263190876,0.19425993232234615,0.6058403308685298
Georgia,13283,Treutlen County,2101,952,3077,1149,0.682807929801755,0.30939226519337015,0.3734156646083848
Georgia,13285,Troup County,18097,11542,29967,6555,0.6038976207161211,0.3851570060399773,0.21874061467614375
Georgia,13287,Turner County,2349,1410,3792,939,0.6194620253164557,0.37183544303797467,0.247626582278481
Georgia,13289,Twiggs County,2368,2040,4438,328,0.533573681838666,0.4596665164488508,0.07390716538981523
Georgia,13291,Union County,12651,2801,15592,9850,0.8113776295536173,0.17964340687532068,0.6317342226782966
Georgia,13293,Upson County,8602,4201,12899,4401,0.6668734010388402,0.32568416156291186,0.34118923947592833
Georgia,13295,Walker County,23174,5769,29436,17405,0.7872672917515967,0.19598450876477783,0.5912827829868189
Georgia,13297,Walton County,37617,12634,50812,24983,0.7403172478941982,0.24864205305833267,0.4916751948358655
Georgia,13299,Ware County,9930,4249,14296,5681,0.6945998880805819,0.2972160044767767,0.3973838836038052
Georgia,13301,Warren County,1177,1488,2681,-311,0.43901529280119356,0.5550167847817978,-0.11600149198060428
Georgia,13303,Washington County,4663,4730,9462,-67,0.4928133586979497,0.49989431409849927,-0.007080955400549593
Georgia,13305,Wayne County,9987,2687,12790,7300,0.7808444096950743,0.21008600469116498,0.5707584050039093
Georgia,13307,Webster County,748,639,1390,109,0.5381294964028777,0.45971223021582736,0.0784172661870503
Georgia,13309,Wheeler County,1583,688,2286,895,0.6924759405074365,0.3009623797025372,0.39151356080489935
Georgia,13311,White County,12222,2411,14816,9811,0.8249190064794817,0.1627294816414687,0.662189524838013
Georgia,13313,Whitfield County,25636,10670,36746,14966,0.6976541664398846,0.290371741141893,0.40728242529799163
Georgia,13315,Wilcox County,2403,862,3281,1541,0.7323986589454434,0.2627247790307833,0.46967387991466014
Georgia,13317,Wilkes County,2823,2159,5029,664,0.5613442036190097,0.4293100019884669,0.1320342016305428
Georgia,13319,Wilkinson County,2664,2075,4770,589,0.5584905660377358,0.4350104821802935,0.12348008385744236
Georgia,13321,Worth County,6826,2395,9281,4431,0.7354810903997414,0.25805408899903026,0.47742700140071115
Hawaii,15001,Hawaii County,26851,58683,87716,-31832,0.3061129098454102,0.6690113548269415,-0.36289844498153134
Hawaii,15003,Honolulu County,136061,238601,381627,-102540,0.35652875713720467,0.6252204377572865,-0.26869168062008186
Hawaii,15007,Kauai County,11579,21217,33486,-9638,0.3457862987517171,0.6336080750164248,-0.2878217762647077
Hawaii,15009,Maui County,22111,47301,71025,-25190,0.3113129179866244,0.6659767687434002,-0.35466385075677576
Idaho,16001,Ada County,130699,120539,259389,10160,0.5038725620593009,0.46470359190250937,0.039168970156791494
Idaho,16003,Adams County,1941,591,2586,1350,0.7505800464037123,0.228538283062645,0.5220417633410673
Idaho,16005,Bannock County,23331,14682,39771,8649,0.5866334766538432,0.3691634608131553,0.21747001584068792
Idaho,16007,Bear Lake County,2814,350,3215,2464,0.8752721617418352,0.1088646967340591,0.7664074650077761
Idaho,16009,Benewah County,3878,977,4972,2901,0.7799678197908286,0.19650040225261464,0.583467417538214
Idaho,16011,Bingham County,15295,4124,20094,11171,0.7611724893002887,0.20523539364984572,0.555937095650443
Idaho,16013,Blaine County,4031,8919,13343,-4888,0.30210597316945215,0.6684403807239752,-0.366334407554523
Idaho,16015,Boise County,3495,1214,4840,2281,0.7221074380165289,0.2508264462809917,0.47128099173553717
Idaho,16017,Bonner County,18369,8310,27352,10059,0.6715779467680608,0.30381690552793217,0.36776104124012865
Idaho,16019,Bonneville County,37805,14254,53995,23551,0.700157421983517,0.26398740624131867,0.4361700157421984
Idaho,16021,Boundary County,4937,1220,6313,3717,0.7820370663709805,0.19325201964200855,0.5887850467289719
Idaho,16023,Butte County,1202,188,1415,1014,0.8494699646643109,0.13286219081272085,0.71660777385159
Idaho,16025,Camas County,507,149,754,358,0.6724137931034483,0.1976127320954907,0.4748010610079576
Idaho,16027,Canyon County,61759,25881,90438,35878,0.6828877241867357,0.2861739534266569,0.3967137707600788
Idaho,16029,Caribou County,2906,431,3416,2475,0.8507025761124122,0.12617096018735363,0.7245316159250585
Idaho,16031,Cassia County,7907,1464,9643,6443,0.8199730374364824,0.1518199730374365,0.6681530643990459
Idaho,16033,Clark County,264,41,311,223,0.8488745980707395,0.13183279742765272,0.7170418006430868
Idaho,16035,Clearwater County,3453,877,4419,2576,0.781398506449423,0.1984611903145508,0.5829373161348722
Idaho,16037,Custer County,2089,603,2737,1486,0.7632444282060651,0.22031421264157838,0.5429302155644867
Idaho,16039,Elmore County,7246,2601,10205,4645,0.7100440960313572,0.254875061244488,0.4551690347868692
Idaho,16041,Franklin County,5845,657,6664,5188,0.8771008403361344,0.09858943577430973,0.7785114045618247
Idaho,16043,Fremont County,5548,998,6719,4550,0.8257181128144069,0.14853400803691025,0.6771841047774967
Idaho,16045,Gem County,7951,1803,9958,6148,0.7984535047198232,0.1810604539064069,0.6173930508134163
Idaho,16047,Gooding County,4659,1256,6050,3403,0.7700826446280992,0.20760330578512395,0.5624793388429752
Idaho,16049,Idaho County,7826,1561,9602,6265,0.8150385336388253,0.16257029785461363,0.6524682357842116
Idaho,16051,Jefferson County,12099,1658,14171,10441,0.8537859007832899,0.1169995060334486,0.7367863947498413
Idaho,16053,Jerome County,5734,1893,7812,3841,0.7339989759344598,0.2423195084485407,0.4916794674859192
Idaho,16055,Kootenai County,62837,24312,89878,38525,0.6991366074011438,0.27050001112619326,0.42863659627495054
Idaho,16057,Latah County,9463,10199,20521,-736,0.4611373714731251,0.4970030700258272,-0.03586569855270211
Idaho,16059,Lemhi County,3592,1032,4738,2560,0.7581257914731955,0.2178134233853947,0.5403123680878008
Idaho,16061,Lewis County,1489,349,1870,1140,0.7962566844919786,0.18663101604278076,0.6096256684491979
Idaho,16063,Lincoln County,1469,414,1940,1055,0.7572164948453608,0.2134020618556701,0.5438144329896907
Idaho,16065,Madison County,13559,2666,17112,10893,0.7923679289387564,0.15579710144927536,0.636570827489481
Idaho,16067,Minidoka County,6265,1550,7993,4715,0.7838108344801702,0.1939196797197548,0.5898911547604154
Idaho,16069,Nez Perce County,13738,6686,20967,7052,0.6552201077884294,0.31888205274955883,0.3363380550388706
Idaho,16071,Oneida County,2148,249,2451,1899,0.8763769889840881,0.10159118727050184,0.7747858017135862
Idaho,16073,Owyhee County,3819,816,4742,3003,0.8053563897089836,0.1720792914382117,0.6332770982707718
Idaho,16075,Payette County,8862,2161,11293,6701,0.7847339059594439,0.1913574780837687,0.5933764278756752
Idaho,16077,Power County,2116,865,3086,1251,0.6856772521062865,0.280298120544394,0.4053791315618925
Idaho,16079,Shoshone County,4216,1693,6049,2523,0.6969747065630683,0.27988097206149776,0.4170937345015705
Idaho,16081,Teton County,2858,3318,6347,-460,0.4502914762880101,0.5227666614148416,-0.07247518512683154
Idaho,16083,Twin Falls County,25897,9391,36680,16506,0.7060250817884406,0.2560250817884406,0.45
Idaho,16085,Valley County,3947,2976,7063,971,0.5588276936146114,0.4213507008353391,0.13747699277927228
Idaho,16087,Washington County,4154,1073,5344,3081,0.7773203592814372,0.20078592814371257,0.5765344311377246
Illinois,17001,Adams County,24131,8569,33434,15562,0.7217503140515643,0.25629598612191185,0.46545432792965247
Illinois,17003,Alexander County,3056,2522,5631,534,0.5427099982241165,0.4478778192150595,0.094832179009057
Illinois,17005,Bond County,5612,2275,8109,3337,0.6920705389073869,0.2805524725613516,0.4115180663460353
Illinois,17007,Boone County,13762,10372,24672,3390,0.5577983138780804,0.42039559014267186,0.13740272373540857
Illinois,17009,Brown County,1930,485,2523,1445,0.7649623464130004,0.19223147047166073,0.5727308759413396
Illinois,17011,Bureau County,10296,6545,17182,3751,0.5992317541613317,0.38092189500640206,0.21830985915492962
Illinois,17013,Calhoun County,2043,674,2767,1369,0.738344777737622,0.24358511022768342,0.49475966750993855
Illinois,17015,Carroll County,5098,2737,8006,2361,0.6367724206844866,0.3418685985510867,0.2949038221333999
Illinois,17017,Cass County,3624,1615,5325,2009,0.6805633802816902,0.3032863849765258,0.37727699530516434
Illinois,17019,Champaign County,34774,55173,93019,-20399,0.3738376030703405,0.5931368860125351,-0.21929928294219464
Illinois,17021,Christian County,11505,4286,16094,7219,0.7148626817447497,0.26631042624580586,0.4485522554989438
Illinois,17023,Clark County,6215,1990,8340,4225,0.7452038369304557,0.23860911270983212,0.5065947242206236
Illinois,17025,Clay County,5626,1129,6896,4497,0.8158352668213457,0.16371809744779584,0.6521171693735498
Illinois,17027,Clinton County,14264,4459,19139,9805,0.7452844976226554,0.23297977950781126,0.5123047181148441
Illinois,17029,Coles County,13981,7997,22470,5984,0.6222073876279484,0.355896751223854,0.26631063640409436
Illinois,17031,Cook County,483186,1374757,1886299,-891571,0.2561555723668411,0.7288118161542788,-0.4726562437874377
Illinois,17033,Crawford County,7025,2198,9419,4827,0.7458328909650705,0.23335810595604628,0.5124747850090243
Illinois,17035,Cumberland County,4595,1141,5843,3454,0.7864110901933938,0.1952763991100462,0.5911346910833476
Illinois,17037,DeKalb County,21818,24484,47717,-2666,0.4572374625395561,0.5131085357419788,-0.05587107320242268
Illinois,17039,De Witt County,5623,2171,7994,3452,0.7034025519139354,0.2715786840130098,0.43182386790092564
Illinois,17041,Douglas County,6221,2327,8746,3894,0.7112965927281043,0.26606448662245596,0.44523210610564834
Illinois,17043,DuPage County,187957,269638,467186,-81681,0.40231727834310105,0.5771534249742073,-0.17483614663110625
Illinois,17045,Edgar County,6169,1869,8152,4300,0.7567468105986261,0.22926889106967616,0.52747791952895
Illinois,17047,Edwards County,2833,488,3368,2345,0.8411520190023754,0.14489311163895488,0.6962589073634204
Illinois,17049,Effingham County,14983,3700,19041,11283,0.7868809411270417,0.19431752534005567,0.592563415786986
Illinois,17051,Fayette County,8025,1815,10033,6210,0.7998604604804146,0.18090302003388817,0.6189574404465265
Illinois,17053,Ford County,4956,1691,6809,3265,0.7278601850491996,0.2483477750036716,0.47951241004552797
Illinois,17055,Franklin County,13514,4690,18488,8824,0.7309606231068801,0.2536780614452618,0.47728256166161837
Illinois,17057,Fulton County,9798,6371,16517,3427,0.59320699884967,0.38572379972149906,0.20748319912817093
Illinois,17059,Gallatin County,2019,621,2673,1398,0.755331088664422,0.23232323232323232,0.5230078563411897
Illinois,17061,Greene County,4767,1349,6224,3418,0.7659061696658098,0.21674164524421594,0.5491645244215939
Illinois,17063,Grundy County,16372,9445,26400,6927,0.6201515151515151,0.35776515151515154,0.2623863636363636
Illinois,17065,Hamilton County,3429,821,4316,2608,0.7944856348470807,0.1902224281742354,0.6042632066728453
Illinois,17067,Hancock County,5309,1114,6565,4195,0.8086824067022087,0.16968773800456968,0.638994668697639
Illinois,17069,Hardin County,0,0,0,0,NaN,NaN,NaN
Illinois,17071,Henderson County,2391,1186,3652,1205,0.654709748083242,0.3247535596933187,0.3299561883899233
Illinois,17073,Henry County,15266,9762,25624,5504,0.5957695910084296,0.38097096472057446,0.21479862628785518
Illinois,17075,Iroquois County,10858,2895,14011,7963,0.7749625294411534,0.20662336735422168,0.5683391620869317
Illinois,17077,Jackson County,10835,11104,22575,-269,0.47995570321151715,0.4918715393133998,-0.011915836101882626
Illinois,17079,Jasper County,4492,1006,5582,3486,0.8047294876388391,0.1802221426012182,0.624507345037621
Illinois,17081,Jefferson County,12461,4597,17409,7864,0.7157791946694239,0.26405882015049686,0.451720374518927
Illinois,17083,Jersey County,8699,2956,11942,5743,0.7284374476637079,0.24752972701390052,0.48090772064980736
Illinois,17085,Jo Daviess County,7161,5097,12477,2064,0.5739360423178649,0.408511661457081,0.16542438086078387
Illinois,17087,Johnson County,5052,1280,6442,3772,0.7842285004656939,0.19869605712511643,0.5855324433405775
Illinois,17089,Kane County,96739,130069,231734,-33330,0.4174570844157525,0.5612857845633356,-0.14382870014758303
Illinois,17091,Kankakee County,28410,20112,49729,8298,0.5712964266323474,0.40443202155683805,0.16686440507550931
Illinois,17093,Kendall County,28515,31394,61327,-2879,0.4649664911050598,0.5119115560845957,-0.04694506497953593
Illinois,17095,Knox County,11818,10421,22716,1397,0.5202500440218348,0.45875154076421903,0.0614985032576158
Illinois,17097,Lake County,105416,144674,254827,-39258,0.4136767297028965,0.5677341882924494,-0.1540574585895529
Illinois,17099,LaSalle County,29482,21491,52053,7991,0.5663842621943019,0.4128676541217605,0.15351660807254142
Illinois,17101,Lawrence County,4849,1414,6379,3435,0.7601504938078069,0.22166483774886345,0.5384856560589434
Illinois,17103,Lee County,9584,6368,16351,3216,0.5861415203963061,0.3894563023668277,0.19668521802947836
Illinois,17105,Livingston County,12134,4568,17049,7566,0.7117132969675641,0.26793360314387943,0.4437796938236847
Illinois,17107,Logan County,9042,3769,13117,5273,0.6893344514751849,0.28733704353129524,0.40199740794388966
Illinois,17109,McDonough County,7009,4973,12290,2036,0.5703010577705452,0.4046379170056957,0.1656631407648495
Illinois,17111,McHenry County,79396,73610,156805,5786,0.5063358949013106,0.46943656133414113,0.03689933356716946
Illinois,17113,McLean County,40365,43719,87013,-3354,0.4638961994184777,0.5024421638146024,-0.03854596439612468
Illinois,17115,Macon County,28373,19633,48934,8740,0.5798218007929047,0.4012138799198921,0.17860792087301258
Illinois,17117,Macoupin County,16058,7313,23919,8745,0.6713491366695932,0.30574020653037337,0.3656089301392198
Illinois,17119,Madison County,75727,56845,136141,18882,0.556239487002446,0.4175450452104803,0.13869444179196566
Illinois,17121,Marion County,12540,4396,17214,8144,0.7284768211920529,0.255373533170675,0.4731032880213779
Illinois,17123,Marshall County,4196,2004,6343,2192,0.6615166325082769,0.31593883020652686,0.34557780230175
Illinois,17125,Mason County,4645,1984,6756,2661,0.6875370041444642,0.29366489046773236,0.3938721136767318
Illinois,17127,Massac County,4989,1719,6803,3270,0.7333529325297663,0.2526826400117595,0.4806702925180068
Illinois,17129,Menard County,4722,2003,6889,2719,0.6854405574103644,0.2907533749455654,0.39468718246479895
Illinois,17131,Mercer County,5328,3212,8750,2116,0.6089142857142857,0.3670857142857143,0.24182857142857145
Illinois,17133,Monroe County,14046,6489,21024,7557,0.668093607305936,0.3086472602739726,0.35944634703196343
Illinois,17135,Montgomery County,9504,3889,13701,5615,0.6936719947449091,0.28384789431428364,0.4098241004306255
Illinois,17137,Morgan County,9903,5020,15229,4883,0.6502725064022589,0.3296342504432333,0.32063825595902556
Illinois,17139,Moultrie County,4938,1645,6698,3293,0.7372349955210511,0.2455957002090176,0.4916392953120335
Illinois,17141,Ogle County,16092,9300,26040,6792,0.6179723502304147,0.35714285714285715,0.2608294930875576
Illinois,17143,Peoria County,37612,42600,82264,-4988,0.4572109306622581,0.5178449868715356,-0.060634056209277476
Illinois,17145,Perry County,7305,2609,10060,4696,0.7261431411530815,0.2593439363817097,0.4667992047713718
Illinois,17147,Piatt County,6219,3302,9791,2917,0.6351751608620161,0.3372484935144521,0.297926667347564
Illinois,17149,Pike County,6235,1458,7836,4777,0.7956865747830526,0.1860643185298622,0.6096222562531904
Illinois,17151,Pope County,1720,432,2172,1288,0.7918968692449355,0.19889502762430938,0.5930018416206262
Illinois,17153,Pulaski County,1699,891,2631,808,0.6457620676548841,0.338654503990878,0.3071075636640061
Illinois,17155,Putnam County,1978,1309,3345,669,0.5913303437967115,0.3913303437967115,0.19999999999999996
Illinois,17157,Randolph County,11065,3590,14896,7475,0.7428168635875403,0.2410042964554243,0.501812567132116
Illinois,17159,Richland County,7988,1355,9343,6633,0.8549716365193193,0.1450283634806807,0.7099432730386386
Illinois,17161,Rock Island County,28585,36647,66750,-8062,0.42823970037453185,0.5490187265917603,-0.12077902621722847
Illinois,17163,St. Clair County,56000,66698,125220,-10698,0.44721290528669544,0.5326465420859288,-0.08543363679923333
Illinois,17165,Saline County,8096,2786,11079,5310,0.7307518729127177,0.25146673887534976,0.47928513403736794
Illinois,17167,Sangamon County,53303,48756,104395,4547,0.5105895876239284,0.46703386177498923,0.04355572584893913
Illinois,17169,Schuyler County,2767,1064,3908,1703,0.7080348004094166,0.27226202661207777,0.4357727737973388
Illinois,17171,Scott County,2104,569,2730,1535,0.7706959706959707,0.20842490842490843,0.5622710622710623
Illinois,17173,Shelby County,9396,2488,12049,6908,0.7798157523445929,0.20649016515893434,0.5733255871856585
Illinois,17175,Stark County,2000,814,2881,1186,0.6942034015966678,0.2825407844498438,0.411662617146824
Illinois,17177,Stephenson County,12253,8756,21446,3497,0.5713419751935093,0.40828126457148184,0.16306071062202743
Illinois,17179,Tazewell County,42194,24486,68358,17708,0.6172503584072091,0.3582024049855174,0.2590479534216917
Illinois,17181,Union County,6157,2575,8896,3582,0.6921088129496403,0.2894559352517986,0.40265287769784175
Illinois,17183,Vermilion County,20710,10313,31617,10397,0.6550273586994338,0.32618528007084796,0.3288420786285859
Illinois,17185,Wabash County,4228,1248,5592,2980,0.7560801144492132,0.22317596566523606,0.5329041487839772
Illinois,17187,Warren County,4671,3087,7916,1584,0.5900707427993936,0.38996968165740276,0.2001010611419909
Illinois,17189,Washington County,6110,1639,7914,4471,0.7720495324740966,0.20710133939853426,0.5649481930755623
Illinois,17191,Wayne County,7172,1185,8446,5987,0.8491593653800615,0.14030310206014682,0.7088562633199147
Illinois,17193,White County,5788,1517,7428,4271,0.7792137856758212,0.20422724824986538,0.5749865374259558
Illinois,17195,Whiteside County,14472,12195,27254,2277,0.5310046231745799,0.447457253981067,0.08354736919351285
Illinois,17197,Will County,149695,174226,330593,-24531,0.45280753070996665,0.5270105537624814,-0.07420302305251475
Illinois,17199,Williamson County,22681,10107,33503,12574,0.676984150673074,0.3016744769125153,0.37530967376055874
Illinois,17201,Winnebago County,60390,58721,121684,1669,0.4962854607014891,0.4825696065218106,0.013715854179678522
Illinois,17203,Woodford County,14590,5976,21079,8614,0.6921580720148015,0.28350491010009965,0.40865316191470186
Indiana,18001,Adams County,10685,3236,14238,7449,0.750456524792808,0.22727911223486444,0.5231774125579436
Indiana,18003,Allen County,91885,72825,168964,19060,0.5438140669018252,0.43100897232546576,0.11280509457635945
Indiana,18005,Bartholomew County,22409,12934,36299,9475,0.6173448304361002,0.3563183558775724,0.26102647455852784
Indiana,18007,Benton County,3007,1009,4115,1998,0.7307411907654922,0.24520048602673147,0.48554070473876065
Indiana,18009,Blackford County,3838,1376,5354,2462,0.7168472170339932,0.25700410907732535,0.4598431079566679
Indiana,18011,Boone County,22351,15244,38622,7107,0.5787116151416292,0.39469732276940606,0.1840142923722231
Indiana,18013,Brown County,5725,2996,8886,2729,0.6442718883637182,0.3371595768624803,0.30711231150123786
Indiana,18015,Carroll County,7086,2224,9514,4862,0.7447971410552869,0.23376077359680472,0.5110363674584822
Indiana,18017,Cass County,10551,4301,15185,6250,0.6948304247612775,0.283240039512677,0.41159038524860053
Indiana,18019,Clark County,33656,23088,58040,10568,0.5798759476223294,0.3977946243969676,0.1820813232253618
Indiana,18021,Clay County,9498,2549,12277,6949,0.7736417691618473,0.2076240123808748,0.5660177567809725
Indiana,18023,Clinton County,9334,3361,12961,5973,0.720160481444333,0.2593164107707739,0.4608440706735591
Indiana,18025,Crawford County,3499,1369,4979,2130,0.7027515565374574,0.27495481020285195,0.4277967463346054
Indiana,18027,Daviess County,9576,2169,11971,7407,0.7999331718319271,0.18118787068749478,0.6187453011444324
Indiana,18029,Dearborn County,19441,5433,25302,14008,0.7683582325507865,0.21472610860801516,0.5536321239427713
Indiana,18031,Decatur County,9570,2436,12296,7134,0.7783018867924528,0.19811320754716982,0.5801886792452831
Indiana,18033,DeKalb County,14237,4966,19656,9271,0.7243080993080994,0.2526455026455027,0.4716625966625967
Indiana,18035,Delaware County,26724,20328,48089,6396,0.5557196032356672,0.4227162136871218,0.13300338954854535
Indiana,18037,Dubois County,15032,6292,21805,8740,0.6893831689979363,0.2885576702591149,0.4008254987388214
Indiana,18039,Elkhart County,46311,25413,73225,20898,0.6324479344486172,0.3470536019119153,0.28539433253670193
Indiana,18041,Fayette County,7755,2237,10146,5518,0.764340626848019,0.2204809777252119,0.543859649122807
Indiana,18043,Floyd County,23385,17507,41742,5878,0.5602271093862297,0.4194097072492933,0.1408174021369364
Indiana,18045,Fountain County,6151,1627,7978,4524,0.7709952369014791,0.20393582351466533,0.5670594133868138
Indiana,18047,Franklin County,9691,2137,12018,7554,0.8063737726743219,0.1778166084207023,0.6285571642536196
Indiana,18049,Fulton County,6667,2274,9110,4393,0.7318331503841932,0.24961580680570802,0.4822173435784851
Indiana,18051,Gibson County,11817,4027,16165,7790,0.731023816888339,0.2491184658212187,0.4819053510671203
Indiana,18053,Grant County,18543,8015,27230,10528,0.6809768637532133,0.2943444730077121,0.3866323907455012
Indiana,18055,Greene County,11103,3389,14807,7714,0.7498480448436551,0.2288782332680489,0.5209698115756062
Indiana,18057,Hamilton County,101563,88367,194447,13196,0.522317135260508,0.4544528843335202,0.06786425092698783
Indiana,18059,Hancock County,28816,12821,42645,15995,0.6757181381170125,0.3006448587173174,0.37507327939969515
Indiana,18061,Harrison County,14542,5334,20198,9208,0.719972274482622,0.264085553025052,0.45588672145757003
Indiana,18063,Hendricks County,53688,32453,88430,21235,0.6071242790908062,0.36699084021259754,0.2401334388782087
Indiana,18065,Henry County,15043,5543,21020,9500,0.715651760228354,0.2637012369172217,0.4519505233111323
Indiana,18067,Howard County,26400,13270,40619,13130,0.6499421453014599,0.32669440409660505,0.32324774120485483
Indiana,18069,Huntington County,13147,4254,17809,8893,0.7382222471783929,0.23886798809590656,0.4993542590824863
Indiana,18071,Jackson County,14555,4302,19238,10253,0.7565755276016218,0.22361991891048966,0.5329556086911322
Indiana,18073,Jasper County,11383,3798,15495,7585,0.734624072281381,0.24511132623426912,0.4895127460471119
Indiana,18075,Jay County,6361,1926,8466,4435,0.7513583746751713,0.22749822820694543,0.5238601464682259
Indiana,18077,Jefferson County,9659,4732,14726,4927,0.6559147086785277,0.3213364117886731,0.33457829688985463
Indiana,18079,Jennings County,9488,2521,12272,6967,0.7731421121251629,0.2054269882659713,0.5677151238591917
Indiana,18081,Johnson County,51209,24729,77784,26480,0.6583487606705749,0.3179188522061092,0.3404299084644657
Indiana,18083,Knox County,11654,4067,16027,7587,0.7271479378548699,0.25375928121295316,0.4733886566419167
Indiana,18085,Kosciusko County,26476,8350,35846,18126,0.7386040283434693,0.23294091390950175,0.5056631144339675
Indiana,18087,LaGrange County,8110,2355,10633,5755,0.7627198344775699,0.22148029718799964,0.5412395372895702
Indiana,18089,Lake County,91733,124801,220233,-33068,0.4165270418148052,0.5666771101515213,-0.15015006833671612
Indiana,18091,LaPorte County,25991,22419,49469,3572,0.5253997452950333,0.4531929086902909,0.07220683660474242
Indiana,18093,Lawrence County,15601,4961,21071,10640,0.7404014996915191,0.23544207678800247,0.5049594229035167
Indiana,18095,Madison County,31153,19459,51711,11694,0.6024443541993,0.37630291427355883,0.22614143992574115
Indiana,18097,Marion County,133902,247034,390106,-113132,0.34324516926168785,0.6332483991530508,-0.2900032298913629
Indiana,18099,Marshall County,13841,5712,19934,8129,0.6943413263770443,0.2865456004815892,0.40779572589545504
Indiana,18101,Martin County,4029,1011,5155,3018,0.7815712900096993,0.19612027158098932,0.58545101842871
Indiana,18103,Miami County,10925,3235,14493,7690,0.7538121851928518,0.22321120540950803,0.5306009797833438
Indiana,18105,Monroe County,22062,39855,63020,-17793,0.3500793398920978,0.6324182799111393,-0.28233894001904153
Indiana,18107,Montgomery County,12659,4212,17197,8447,0.7361167645519567,0.24492644065825434,0.49119032389370243
Indiana,18109,Morgan County,27510,7777,36214,19733,0.7596509637156901,0.21475120119290883,0.5448997625227813
Indiana,18111,Newton County,4942,1509,6606,3433,0.7481077808053285,0.22842870118074476,0.5196790796245837
Indiana,18113,Noble County,14195,4660,19217,9535,0.7386688869230369,0.24249362543581204,0.49617526148722485
Indiana,18115,Ohio County,2392,750,3164,1642,0.7560050568900126,0.2370417193426043,0.5189633375474083
Indiana,18117,Orange County,6432,2224,8833,4208,0.7281784218272388,0.2517830861541945,0.4763953356730443
Indiana,18119,Owen County,7285,2419,9915,4866,0.734745335350479,0.24397377710539586,0.4907715582450832
Indiana,18121,Parke County,5398,1503,7020,3895,0.7689458689458689,0.2141025641025641,0.5548433048433048
Indiana,18123,Perry County,5343,3202,8734,2141,0.6117471948706206,0.3666132356308679,0.24513395923975267
Indiana,18125,Pike County,4692,1415,6220,3277,0.7543408360128617,0.227491961414791,0.5268488745980707
Indiana,18127,Porter County,44899,39537,86284,5362,0.5203629873441195,0.4582193685967271,0.06214361874739238
Indiana,18129,Posey County,9206,3811,13264,5395,0.6940591073582629,0.2873190591073583,0.40674004825090465
Indiana,18131,Pulaski County,4246,1463,5813,2783,0.7304317908136935,0.251677275073112,0.4787545157405815
Indiana,18133,Putnam County,12278,3946,16595,8332,0.7398614040373607,0.23778246459777042,0.5020789394395903
Indiana,18135,Randolph County,8312,2512,11078,5800,0.7503159415056869,0.22675573208160318,0.5235602094240838
Indiana,18137,Ripley County,11261,2774,14280,8487,0.7885854341736694,0.1942577030812325,0.594327731092437
Indiana,18139,Rush County,6035,1754,7938,4281,0.7602670697908793,0.22096245905769715,0.5393046107331821
Indiana,18141,St. Joseph County,53152,59870,115547,-6718,0.4600032887050291,0.5181441318251447,-0.05814084312011564
Indiana,18143,Scott County,7328,2698,10176,4630,0.720125786163522,0.26513364779874216,0.4549921383647798
Indiana,18145,Shelby County,14568,5023,20017,9545,0.7277813858220512,0.2509367038017685,0.4768446820202827
Indiana,18147,Spencer County,7354,3208,10781,4146,0.6821259623411557,0.29756052314256565,0.3845654391985901
Indiana,18149,Starke County,7466,2650,10309,4816,0.7242215539819575,0.25705694053739453,0.467164613444563
Indiana,18151,Steuben County,11322,4509,16175,6813,0.6999690880989181,0.2787635239567233,0.4212055641421948
Indiana,18153,Sullivan County,6687,2153,9004,4534,0.7426699244780097,0.23911594846734785,0.5035539760106619
Indiana,18155,Switzerland County,3133,964,4152,2169,0.7545761078998073,0.2321772639691715,0.5223988439306358
Indiana,18157,Tippecanoe County,34571,34993,71755,-422,0.4817922096021183,0.4876733328687896,-0.005881123266671284
Indiana,18159,Tipton County,6110,1834,8124,4276,0.7520925652387986,0.22575086164451008,0.5263417035942886
Indiana,18161,Union County,2687,736,3491,1951,0.7696934975651676,0.21082784302492122,0.5588656545402464
Indiana,18163,Vanderburgh County,41838,34404,77563,7434,0.5394066758634916,0.4435620076582907,0.09584466820520088
Indiana,18165,Vermillion County,5184,2145,7490,3039,0.6921228304405874,0.2863818424566088,0.4057409879839786
Indiana,18167,Vigo County,24512,18080,43593,6432,0.5622921111187577,0.41474548666070243,0.14754662445805522
Indiana,18169,Wabash County,10762,3494,14598,7268,0.73722427729826,0.2393478558706672,0.4978764214275928
Indiana,18171,Warren County,3401,974,4473,2427,0.7603398166778449,0.21775095014531634,0.5425888665325286
Indiana,18173,Warrick County,21324,11919,33884,9405,0.6293235745484594,0.35175894227363946,0.27756463227482
Indiana,18175,Washington County,9112,2783,12126,6329,0.7514431799439222,0.22950684479630545,0.5219363351476167
Indiana,18177,Wayne County,17567,9524,27662,8043,0.6350589256019088,0.3442990383920179,0.2907598872098909
Indiana,18179,Wells County,10855,2928,14080,7927,0.7709517045454546,0.20795454545454545,0.5629971590909091
Indiana,18181,White County,7353,2868,10402,4485,0.7068832916746779,0.2757162084214574,0.4311670832532205
Indiana,18183,Whitley County,12856,4233,17581,8623,0.7312439565439963,0.2407712871850293,0.49047266935896705
Iowa,19001,Adair County,2917,1197,4183,1720,0.6973464021037533,0.28615825962228064,0.4111881424814727
Iowa,19003,Adams County,1528,590,2158,938,0.7080630213160334,0.27340129749768305,0.43466172381835033
Iowa,19005,Allamakee County,4733,2575,7459,2158,0.6345354605174957,0.34522053894623944,0.2893149215712562
Iowa,19007,Appanoose County,4508,1889,6500,2619,0.6935384615384615,0.2906153846153846,0.40292307692307694
Iowa,19009,Audubon County,2292,1071,3413,1221,0.6715499560503956,0.3138001757984178,0.3577497802519778
Iowa,19011,Benton County,9179,5156,14627,4023,0.6275381144458877,0.3524988035824161,0.2750393108634716
Iowa,19013,Black Hawk County,29623,35621,66549,-5998,0.4451306556071466,0.5352597334295031,-0.09012907782235646
Iowa,19015,Boone County,8676,6293,15277,2383,0.5679125482751849,0.4119264253452903,0.1559861229298946
Iowa,19017,Bremer County,8287,5954,14534,2333,0.5701802669602312,0.40966010733452596,0.1605201596257052
Iowa,19019,Buchanan County,6418,4167,10759,2251,0.5965238405056232,0.38730365275583234,0.2092201877497909
Iowa,19021,Buena Vista County,5004,2919,8072,2085,0.6199207135777998,0.36162041625371655,0.2583002973240832
Iowa,19023,Butler County,5540,2423,8081,3117,0.685558717980448,0.2998391288206905,0.38571958915975746
Iowa,19025,Calhoun County,3687,1469,5246,2218,0.7028211971025543,0.2800228745711018,0.4227983225314525
Iowa,19027,Carroll County,7720,3444,11277,4276,0.6845792320652656,0.3054003724394786,0.379178859625787
Iowa,19029,Cass County,4969,2201,7266,2768,0.6838700798238371,0.3029176988714561,0.380952380952381
Iowa,19031,Cedar County,6161,4336,10702,1825,0.575686787516352,0.4051579144085218,0.17052887310783027
Iowa,19033,Cerro Gordo County,12435,10941,23794,1494,0.5226107422039169,0.4598218038160881,0.06278893838782879
Iowa,19035,Cherokee County,4495,1936,6503,2559,0.6912194371828387,0.297708749807781,0.39351068737505773
Iowa,19037,Chickasaw County,4299,2230,6605,2069,0.6508705526116578,0.3376230128690386,0.3132475397426192
Iowa,19039,Clarke County,3140,1466,4666,1674,0.6729532790398628,0.3141877411058723,0.3587655379339905
Iowa,19041,Clay County,6126,2653,8928,3473,0.6861559139784946,0.29715501792114696,0.38900089605734767
Iowa,19043,Clayton County,6105,3339,9589,2766,0.6366670142872041,0.3482114923349672,0.2884555219522369
Iowa,19045,Clinton County,13349,10806,24620,2543,0.5422014622258327,0.4389114541023558,0.10329000812347683
Iowa,19047,Crawford County,4842,2211,7125,2631,0.6795789473684211,0.3103157894736842,0.36926315789473685
Iowa,19049,Dallas County,27882,26771,55803,1111,0.49965055642169776,0.47974123255022133,0.019909323871476425
Iowa,19051,Davis County,3032,1013,4099,2019,0.7396926079531593,0.24713344718223956,0.4925591607709197
Iowa,19053,Decatur County,2613,1117,3798,1496,0.6879936808846762,0.294102159031069,0.39389152185360715
Iowa,19055,Delaware County,6666,3157,9981,3509,0.6678689510069131,0.31630097184650835,0.3515679791604048
Iowa,19057,Des Moines County,10589,8887,19897,1702,0.5321907825300296,0.4466502487812233,0.08554053374880632
Iowa,19059,Dickinson County,7432,3660,11223,3772,0.6622115298939677,0.3261160117615611,0.3360955181324066
Iowa,19061,Dubuque County,27214,25655,53924,1559,0.5046732438246421,0.4757621838142571,0.02891106001038496
Iowa,19063,Emmet County,3265,1520,4850,1745,0.6731958762886598,0.3134020618556701,0.35979381443298974
Iowa,19065,Fayette County,6145,3834,10184,2311,0.6033974862529458,0.3764728986645719,0.22692458758837386
Iowa,19067,Floyd County,4730,3168,8026,1562,0.5893346623473711,0.3947171692000997,0.1946174931472714
Iowa,19069,Franklin County,3420,1625,5116,1795,0.6684910086004691,0.3176309616888194,0.3508600469116497
Iowa,19071,Fremont County,2711,1078,3855,1633,0.703242542153048,0.27963683527885863,0.4236057068741894
Iowa,19073,Greene County,3221,1768,5054,1453,0.6373169766521567,0.3498219232291254,0.2874950534230313
Iowa,19075,Grundy County,4911,2194,7245,2717,0.6778467908902691,0.3028295376121463,0.3750172532781228
Iowa,19077,Guthrie County,4272,1985,6369,2287,0.670748940178992,0.31166588161406816,0.35908305856492384
Iowa,19079,Hamilton County,4956,2842,8516,2114,0.5819633630812588,0.3337247534053546,0.24823860967590422
Iowa,19081,Hancock County,4386,1682,6164,2704,0.7115509409474368,0.272874756651525,0.43867618429591176
Iowa,19083,Hardin County,5842,2971,8962,2871,0.6518634233430038,0.33151082347690247,0.3203525998661014
Iowa,19085,Harrison County,5563,2439,8137,3124,0.6836671992134693,0.29974191962639796,0.38392527958707134
Iowa,19087,Henry County,6483,3264,9929,3219,0.652935844495921,0.32873401148151876,0.32420183301440225
Iowa,19089,Howard County,3126,1772,4951,1354,0.6313875984649566,0.3579074934356696,0.27348010502928705
Iowa,19091,Humboldt County,3818,1442,5320,2376,0.7176691729323308,0.2710526315789474,0.4466165413533834
Iowa,19093,Ida County,2876,917,3845,1959,0.7479843953185956,0.23849154746423928,0.5094928478543563
Iowa,19095,Iowa County,6009,3546,9741,2463,0.6168771173390822,0.36402833384662764,0.2528487834924546
Iowa,19097,Jackson County,6940,4029,11118,2911,0.6242129879474726,0.3623853211009174,0.2618276668465552
Iowa,19099,Jasper County,12480,7813,20653,4667,0.6042705660194645,0.37829855226843556,0.22597201375102893
Iowa,19101,Jefferson County,4442,4314,8952,128,0.4962019660411081,0.4819034852546917,0.014298480786416434
Iowa,19103,Johnson County,22918,59147,83533,-36229,0.27435863670645133,0.7080674703410628,-0.43370883363461143
Iowa,19105,Jones County,6569,4211,10959,2358,0.5994160051099553,0.3842503878091067,0.2151656173008486
Iowa,19107,Keokuk County,3785,1409,5273,2376,0.7178076996017447,0.26721031670775647,0.45059738289398826
Iowa,19109,Kossuth County,6244,2681,9030,3563,0.6914728682170542,0.29689922480620157,0.39457364341085266
Iowa,19111,Lee County,9763,6539,16721,3224,0.5838765624065546,0.39106512768375096,0.19281143472280365
Iowa,19113,Linn County,53098,70451,126716,-17353,0.4190315350863348,0.5559755674105874,-0.13694403232425262
Iowa,19115,Louisa County,3500,1726,5326,1774,0.6571535861809988,0.3240705970709726,0.33308298911002626
Iowa,19117,Lucas County,2981,1220,4299,1761,0.6934170737380786,0.2837869271923703,0.4096301465457083
Iowa,19119,Lyon County,5703,1065,6846,4638,0.8330411919368974,0.15556529360210342,0.6774758983347939
Iowa,19121,Madison County,6486,3126,9795,3360,0.6621745788667688,0.31914241960183765,0.34303215926493114
Iowa,19123,Mahaska County,8256,2879,11346,5377,0.7276573241671074,0.253745813502556,0.4739115106645514
Iowa,19125,Marion County,12657,6170,19217,6487,0.6586355830774835,0.3210698860384035,0.33756569703908
Iowa,19127,Marshall County,9564,8171,18122,1393,0.5277563182871647,0.45088842291137843,0.07686789537578631
Iowa,19129,Mills County,5572,2500,8247,3072,0.6756396265308597,0.30314053595246754,0.3724990905783922
Iowa,19131,Mitchell County,3665,2048,5797,1617,0.6322235639123684,0.3532861825081939,0.27893738140417457
Iowa,19133,Monona County,3234,1402,4709,1832,0.6867700148651519,0.29772775536207263,0.38904225950307925
Iowa,19135,Monroe County,2975,1078,4085,1897,0.7282741738066095,0.2638922888616891,0.46438188494492044
Iowa,19137,Montgomery County,3653,1583,5313,2070,0.6875588179936006,0.297948428383211,0.38961038961038963
Iowa,19139,Muscatine County,10823,9372,20671,1451,0.5235837646944995,0.453388805573025,0.0701949591214745
Iowa,19141,O'Brien County,5857,1567,7535,4290,0.777305905773059,0.2079628400796284,0.5693430656934306
Iowa,19143,Osceola County,2688,600,3325,2088,0.8084210526315789,0.18045112781954886,0.6279699248120301
Iowa,19145,Page County,5314,2081,7509,3233,0.7076841123984552,0.2771341057397789,0.43055000665867627
Iowa,19147,Palo Alto County,3369,1518,4948,1851,0.6808811641067097,0.30679062247372674,0.374090541632983
Iowa,19149,Plymouth County,10472,3483,14157,6989,0.7397047397047397,0.24602670057215512,0.49367803913258457
Iowa,19151,Pocahontas County,2825,932,3821,1893,0.7393352525516881,0.24391520544360115,0.49542004710808696
Iowa,19153,Polk County,106752,146173,258613,-39421,0.4127866735237594,0.565219072513756,-0.1524323989899966
Iowa,19155,Pottawattamie County,26241,18570,45733,7671,0.5737869809546717,0.4060525222487044,0.16773445870596732
Iowa,19157,Poweshiek County,5645,4301,10120,1344,0.557806324110672,0.425,0.132806324110672
Iowa,19159,Ringgold County,1964,708,2709,1256,0.7249907715023994,0.26135105204872644,0.463639719453673
Iowa,19161,Sac County,4052,1383,5512,2669,0.7351233671988389,0.25090711175616837,0.4842162554426705
Iowa,19163,Scott County,43661,46890,92639,-3229,0.4713025831453276,0.5061583134532972,-0.03485573030796962
Iowa,19165,Shelby County,4697,1959,6781,2738,0.6926706975372364,0.2888954431499779,0.40377525438725853
Iowa,19167,Sioux County,15669,3017,18943,12652,0.8271657076492636,0.15926727551074277,0.6678984321385208
Iowa,19169,Story County,20200,28975,50668,-8775,0.3986737191126549,0.5718599510539196,-0.1731862319412647
Iowa,19171,Tama County,5299,3573,9017,1726,0.5876677387157592,0.396251524897416,0.19141621381834317
Iowa,19173,Taylor County,2459,745,3237,1714,0.759654000617856,0.230151374729688,0.5295026258881681
Iowa,19175,Union County,4000,2049,6163,1951,0.649034561090378,0.33246795391854617,0.3165666071718319
Iowa,19177,Van Buren County,2867,874,3795,1993,0.755467720685112,0.23030303030303031,0.5251646903820817
Iowa,19179,Wapello County,9504,5818,15607,3686,0.6089575190619594,0.37278144422374576,0.23617607483821362
Iowa,19181,Warren County,17738,12537,30955,5201,0.5730253593926667,0.4050072686157325,0.16801809077693425
Iowa,19183,Washington County,6966,4558,11757,2408,0.5924980862464915,0.3876839329760993,0.20481415327039215
Iowa,19185,Wayne County,2338,727,3103,1611,0.7534643893006767,0.23428939735739607,0.5191749919432807
Iowa,19187,Webster County,10927,6604,17802,4323,0.613807437366588,0.3709695539826986,0.24283788338388945
Iowa,19189,Winnebago County,3692,2123,5931,1569,0.6224919912325072,0.35794975552183445,0.26454223571067276
Iowa,19191,Winneshiek County,6234,5616,12034,618,0.5180322419810537,0.4666777463852418,0.0513544955958119
Iowa,19193,Woodbury County,25700,18683,45114,7017,0.5696679522986212,0.41412865185973313,0.15553930043888808
Iowa,19195,Worth County,2732,1593,4405,1139,0.6202043132803632,0.3616345062429058,0.2585698070374574
Iowa,19197,Wright County,4135,1995,6240,2140,0.6626602564102564,0.31971153846153844,0.34294871794871795
Kansas,20001,Allen County,5486,1836,7484,3650,0.7330304649919829,0.24532335649385356,0.4877071084981293
Kansas,20003,Anderson County,2874,765,3720,2109,0.7725806451612903,0.2056451612903226,0.5669354838709677
Kansas,20005,Atchison County,4826,2314,7312,2512,0.6600109409190372,0.3164660831509847,0.34354485776805255
Kansas,20007,Barber County,1992,284,2313,1708,0.8612191958495461,0.12278426286208387,0.7384349329874622
Kansas,20009,Barton County,8480,2302,10980,6178,0.7723132969034608,0.20965391621129326,0.5626593806921676
Kansas,20011,Bourbon County,4906,1504,6545,3402,0.7495798319327731,0.22979373567608863,0.5197860962566845
Kansas,20013,Brown County,3206,1088,4396,2118,0.7292993630573248,0.24749772520473157,0.4818016378525932
Kansas,20015,Butler County,22250,9003,31946,13247,0.6964878232016528,0.28181932010267324,0.41466850309897957
Kansas,20017,Chase County,1114,341,1478,773,0.7537212449255751,0.2307171853856563,0.5230040595399188
Kansas,20019,Chautauqua County,1397,212,1634,1185,0.8549571603427173,0.12974296205630356,0.7252141982864138
Kansas,20021,Cherokee County,6622,2163,8945,4459,0.7403018446059251,0.24181106763555058,0.49849077697037447
Kansas,20023,Cheyenne County,1158,220,1400,938,0.8271428571428572,0.15714285714285714,0.67
Kansas,20025,Clark County,885,143,1048,742,0.8444656488549618,0.1364503816793893,0.7080152671755725
Kansas,20027,Clay County,3120,879,4121,2241,0.7570977917981072,0.21329774326619752,0.5438000485319097
Kansas,20029,Cloud County,3182,893,4179,2289,0.7614261785116057,0.21368748504426896,0.5477386934673367
Kansas,20031,Coffey County,3403,926,4442,2477,0.7660963529941468,0.20846465556055832,0.5576316974335884
Kansas,20033,Comanche County,743,124,900,619,0.8255555555555556,0.13777777777777778,0.6877777777777778
Kansas,20035,Cowley County,9442,4171,13958,5271,0.6764579452643645,0.29882504656827624,0.3776328986960883
Kansas,20037,Crawford County,9752,5971,16193,3781,0.602235533872661,0.3687395788303588,0.23349595504230225
Kansas,20039,Decatur County,1232,208,1458,1024,0.8449931412894376,0.14266117969821673,0.7023319615912209
Kansas,20041,Dickinson County,7045,2040,9246,5005,0.7619511139952412,0.22063595068137573,0.5413151633138654
Kansas,20043,Doniphan County,2949,678,3682,2271,0.8009234111895709,0.18413905486148832,0.6167843563280826
Kansas,20045,Douglas County,16737,39436,57946,-22699,0.28883788354675044,0.680564663652366,-0.39172678010561557
Kansas,20047,Edwards County,1127,267,1413,860,0.7975937721160651,0.18895966029723993,0.6086341118188252
Kansas,20049,Elk County,1130,191,1347,939,0.8389012620638456,0.14179658500371195,0.6971046770601337
Kansas,20051,Ellis County,9569,3633,13552,5936,0.706095041322314,0.2680785123966942,0.4380165289256198
Kansas,20053,Ellsworth County,2106,646,2813,1460,0.7486669036615713,0.22964806256665482,0.5190188410949165
Kansas,20055,Finney County,7079,4155,11506,2924,0.6152442204067443,0.36111593950982096,0.25412828089692335
Kansas,20057,Ford County,5763,2926,8850,2837,0.651186440677966,0.3306214689265537,0.32056497175141235
Kansas,20059,Franklin County,8326,3623,12247,4703,0.6798399608067281,0.29582754960398466,0.3840124112027435
Kansas,20061,Geary County,5193,3825,9311,1368,0.5577274191816132,0.4108044248738052,0.14692299430780797
Kansas,20063,Gove County,1256,163,1433,1093,0.8764829030006979,0.1137473831123517,0.7627355198883462
Kansas,20065,Graham County,1052,222,1302,830,0.8079877112135176,0.17050691244239632,0.6374807987711213
Kansas,20067,Grant County,1910,497,2452,1413,0.7789559543230016,0.20269168026101142,0.5762642740619901
Kansas,20069,Gray County,1871,337,2240,1534,0.8352678571428571,0.15044642857142856,0.6848214285714286
Kansas,20071,Greeley County,537,76,628,461,0.8550955414012739,0.12101910828025478,0.7340764331210191
Kansas,20073,Greenwood County,2404,562,3036,1842,0.7918313570487484,0.18511198945981555,0.6067193675889329
Kansas,20075,Hamilton County,684,134,837,550,0.8172043010752689,0.16009557945041816,0.6571087216248507
Kansas,20077,Harper County,2128,453,2628,1675,0.8097412480974124,0.1723744292237443,0.6373668188736681
Kansas,20079,Harvey County,10015,6652,17120,3363,0.5849883177570093,0.3885514018691589,0.19643691588785045
Kansas,20081,Haskell County,1103,261,1383,842,0.7975415762834418,0.18872017353579176,0.6088214027476501
Kansas,20083,Hodgeman County,866,151,1033,715,0.8383349467570184,0.14617618586640851,0.6921587608906099
Kansas,20085,Jackson County,4435,1852,6468,2583,0.6856833642547928,0.28633271490414347,0.39935064935064934
Kansas,20087,Jefferson County,6167,3097,9545,3070,0.6460974332111052,0.3244630696699843,0.32163436354112096
Kansas,20089,Jewell County,1369,211,1608,1158,0.8513681592039801,0.13121890547263682,0.7201492537313433
Kansas,20091,Johnson County,151280,177925,338343,-26645,0.4471202300623923,0.5258716746024005,-0.07875144454000815
Kansas,20093,Kearny County,1134,255,1413,879,0.802547770700637,0.18046709129511676,0.6220806794055203
Kansas,20095,Kingman County,3098,742,3922,2356,0.7899031106578276,0.1891891891891892,0.6007139214686383
Kansas,20097,Kiowa County,957,153,1139,804,0.8402107111501317,0.13432835820895522,0.7058823529411764
Kansas,20099,Labette County,5639,2607,8414,3032,0.6701925362491087,0.3098407416211077,0.360351794628001
Kansas,20101,Lane County,757,114,888,643,0.8524774774774775,0.12837837837837837,0.7240990990990991
Kansas,20103,Leavenworth County,21378,13753,36115,7625,0.591942406202409,0.3808112972449121,0.21113110895749693
Kansas,20105,Lincoln County,1273,266,1570,1007,0.810828025477707,0.16942675159235668,0.6414012738853504
Kansas,20107,Linn County,3940,863,4911,3077,0.8022805945835879,0.17572795764610058,0.6265526369374873
Kansas,20109,Logan County,1231,185,1437,1046,0.8566457898399443,0.12874043145441894,0.7279053583855254
Kansas,20111,Lyon County,7381,5878,13622,1503,0.5418440757598003,0.43150785494053734,0.11033622081926298
Kansas,20113,McPherson County,9562,3977,13901,5585,0.6878641824329185,0.28609452557369974,0.4017696568592187
Kansas,20115,Marion County,4377,1463,5969,2914,0.7332886580666779,0.2450996816887251,0.4881889763779528
Kansas,20117,Marshall County,3662,1239,5029,2423,0.7281765758600119,0.2463710479220521,0.48180552793795983
Kansas,20119,Meade County,1508,261,1807,1247,0.8345323741007195,0.1444382955174322,0.6900940785832872
Kansas,20121,Miami County,12116,5133,17655,6983,0.6862645143018975,0.2907391673746814,0.3955253469272161
Kansas,20123,Mitchell County,2454,547,3039,1907,0.807502467917078,0.17999341888779205,0.627509049029286
Kansas,20125,Montgomery County,9768,3147,13177,6621,0.7412916445321394,0.2388252257721788,0.5024664187599606
Kansas,20127,Morris County,2085,721,2849,1364,0.7318357318357318,0.25307125307125306,0.47876447876447875
Kansas,20129,Morton County,1004,147,1163,857,0.8632846087704213,0.12639724849527084,0.7368873602751504
Kansas,20131,Nemaha County,4612,920,5637,3692,0.8181656909703743,0.1632073798119567,0.6549583111584176
Kansas,20133,Neosho County,4795,1727,6629,3068,0.723336853220697,0.26052194901191733,0.46281490420877963
Kansas,20135,Ness County,1315,147,1487,1168,0.8843308675184937,0.0988567585743107,0.785474108944183
Kansas,20137,Norton County,1975,360,2386,1615,0.827745180217938,0.15088013411567477,0.6768650461022632
Kansas,20139,Osage County,5589,2091,7883,3498,0.708994037802867,0.26525434479259163,0.4437396930102753
Kansas,20141,Osborne County,1590,275,1904,1315,0.8350840336134454,0.14443277310924368,0.6906512605042017
Kansas,20143,Ottawa County,2581,504,3161,2077,0.8165137614678899,0.15944321417273014,0.6570705472951598
Kansas,20145,Pawnee County,2028,635,2712,1393,0.7477876106194691,0.23414454277286137,0.5136430678466077
Kansas,20147,Phillips County,2855,373,3278,2482,0.8709579011592434,0.11378889566809029,0.7571690054911532
Kansas,20149,Pottawatomie County,9247,3257,12815,5990,0.7215762777994538,0.2541552867733125,0.46742099102614126
Kansas,20151,Pratt County,3087,924,4107,2163,0.7516435354273192,0.22498173849525202,0.5266617969320672
Kansas,20153,Rawlins County,1253,214,1498,1039,0.8364485981308412,0.14285714285714285,0.6935914552736984
Kansas,20155,Reno County,17892,8563,27148,9329,0.659054073964933,0.3154191837336084,0.3436348902313246
Kansas,20157,Republic County,2172,420,2643,1752,0.8217934165720772,0.15891032917139614,0.662883087400681
Kansas,20159,Rice County,3187,953,4230,2234,0.7534278959810875,0.22529550827423167,0.5281323877068558
Kansas,20161,Riley County,11174,11940,24024,-766,0.4651182151182151,0.497002997002997,-0.03188478188478189
Kansas,20163,Rooks County,2294,332,2666,1962,0.8604651162790697,0.1245311327831958,0.7359339834958739
Kansas,20165,Rush County,1425,291,1748,1134,0.8152173913043478,0.16647597254004576,0.648741418764302
Kansas,20167,Russell County,2765,591,3436,2174,0.8047147846332945,0.1720023282887078,0.6327124563445867
Kansas,20169,Saline County,15313,8022,24001,7291,0.6380150827048873,0.3342360734969376,0.30377900920794965
Kansas,20171,Scott County,1991,290,2325,1701,0.8563440860215054,0.12473118279569892,0.7316129032258064
Kansas,20173,Sedgwick County,117653,90820,214488,26833,0.5485295214650703,0.4234269516243333,0.12510256984073698
Kansas,20175,Seward County,3285,1736,5099,1549,0.6442439694057658,0.34045891351245344,0.30378505589331234
Kansas,20177,Shawnee County,39890,42032,84502,-2142,0.47205983290336323,0.49740834536460676,-0.025348512461243533
Kansas,20179,Sheridan County,1237,144,1397,1093,0.8854688618468146,0.10307802433786686,0.7823908375089478
Kansas,20181,Sherman County,2220,385,2669,1835,0.8317721993255901,0.14424878231547397,0.6875234170101161
Kansas,20183,Smith County,1734,328,2092,1406,0.8288718929254302,0.15678776290630975,0.6720841300191205
Kansas,20185,Stafford County,1631,355,2017,1276,0.8086266732771443,0.1760039662865642,0.6326227069905801
Kansas,20187,Stanton County,607,147,767,460,0.7913950456323338,0.19165580182529335,0.5997392438070404
Kansas,20189,Stevens County,1731,233,1997,1498,0.8668002003004507,0.11667501251877817,0.7501251877816725
Kansas,20191,Sumner County,7998,2551,10816,5447,0.7394600591715976,0.2358542899408284,0.5036057692307692
Kansas,20193,Thomas County,4686,642,5422,4044,0.8642567318332719,0.1184064920693471,0.7458502397639248
Kansas,20195,Trego County,1341,238,1603,1103,0.8365564566437929,0.14847161572052403,0.6880848409232688
Kansas,20197,Wabaunsee County,2813,956,3861,1857,0.7285677285677286,0.2476042476042476,0.48096348096348096
Kansas,20199,Wallace County,762,44,817,718,0.9326805385556916,0.05385556915544676,0.8788249694002448
Kansas,20201,Washington County,2332,467,2855,1865,0.8168126094570928,0.16357267950963222,0.6532399299474605
Kansas,20203,Wichita County,803,147,961,656,0.8355879292403746,0.1529656607700312,0.6826222684703434
Kansas,20205,Wilson County,3111,711,3899,2400,0.7978968966401642,0.1823544498589382,0.6155424467812259
Kansas,20207,Woodson County,1189,283,1496,906,0.7947860962566845,0.1891711229946524,0.6056149732620321
Kansas,20209,Wyandotte County,18512,35566,55379,-17054,0.33427833655356726,0.6422290037739937,-0.30795066722042647
Kentucky,21001,Adair County,7275,1391,8766,5884,0.8299110198494182,0.15868126853753137,0.6712297513118868
Kentucky,21003,Allen County,12706,3031,15951,9675,0.796564478716068,0.19001943451821202,0.6065450441978559
Kentucky,21005,Anderson County,9651,3339,13261,6312,0.727773169444235,0.25179096599049844,0.47598220345373654
Kentucky,21007,Ballard County,3356,825,4225,2531,0.7943195266272189,0.1952662721893491,0.5990532544378698
Kentucky,21009,Barren County,14646,5115,20079,9531,0.7294187957567608,0.2547437621395488,0.474675033617212
Kentucky,21011,Bath County,3986,1573,5627,2413,0.7083703572063267,0.27954505064865826,0.42882530655766843
Kentucky,21013,Bell County,8140,1789,10044,6351,0.8104340900039825,0.1781162883313421,0.6323178016726404
Kentucky,21015,Boone County,44811,20897,66953,23914,0.6692903977416994,0.3121144683584007,0.35717592938329873
Kentucky,21017,Bourbon County,6190,3296,9643,2894,0.6419164160530955,0.34180234366898266,0.3001140723841128
Kentucky,21019,Boyd County,14295,7083,21741,7212,0.6575134538429696,0.3257899820615427,0.33172347178142686
Kentucky,21021,Boyle County,8872,5298,14467,3574,0.6132577590378102,0.36621276007465264,0.24704499896315757
Kentucky,21023,Bracken County,3397,799,4244,2598,0.8004241281809613,0.18826578699340246,0.6121583411875589
Kentucky,21025,Breathitt County,4265,1301,5667,2964,0.7526027880712899,0.22957473089818245,0.5230280571731074
Kentucky,21027,Breckinridge County,7699,2350,10194,5349,0.7552481852069844,0.23052776142829115,0.5247204237786933
Kentucky,21029,Bullitt County,30708,10551,41964,20157,0.7317700886474121,0.25142979696883044,0.48034029167858167
Kentucky,21031,Butler County,4960,1078,6125,3882,0.809795918367347,0.176,0.6337959183673469
Kentucky,21033,Caldwell County,4905,1432,6436,3473,0.762119328775637,0.22249844623990056,0.5396208825357365
Kentucky,21035,Calloway County,11351,5794,17453,5557,0.6503752936457916,0.3319773104910331,0.31839798315475853
Kentucky,21037,Campbell County,28482,19373,48833,9109,0.5832531280076997,0.3967194315319558,0.18653369647574386
Kentucky,21039,Carlisle County,2159,463,2638,1696,0.8184230477634572,0.1755117513267627,0.6429112964366945
Kentucky,21041,Carroll County,5490,2146,8444,3344,0.6501657981999053,0.25414495499763146,0.3960208432022738
Kentucky,21043,Carter County,8775,2642,11585,6133,0.7574449719464825,0.22805351747949934,0.5293914544669832
Kentucky,21045,Casey County,6186,960,7240,5226,0.8544198895027625,0.13259668508287292,0.7218232044198896
Kentucky,21047,Christian County,15080,8296,23863,6784,0.6319406612747769,0.34765117545991703,0.28428948581485985
Kentucky,21049,Clark County,17595,8665,26584,8930,0.6618642792657238,0.32594793860969,0.33591634065603376
Kentucky,21051,Clay County,6003,430,6498,5573,0.9238227146814404,0.06617420744844568,0.8576485072329947
Kentucky,21053,Clinton County,4280,603,4932,3677,0.8678021086780211,0.12226277372262774,0.7455393349553934
Kentucky,21055,Crittenden County,3451,731,4242,2720,0.8135313531353136,0.17232437529467232,0.6412069778406413
Kentucky,21057,Cumberland County,2769,508,3309,2261,0.8368087035358114,0.1535207011181626,0.6832880024176488
Kentucky,21059,Daviess County,31023,17283,49240,13740,0.6300365556458164,0.35099512591389115,0.27904142973192525
Kentucky,21061,Edmonson County,4828,1227,6131,3601,0.7874734953514925,0.20013048442342196,0.5873430109280705
Kentucky,21063,Elliott County,2246,712,2995,1534,0.7499165275459099,0.23772954924874792,0.512186978297162
Kentucky,21065,Estill County,5100,1355,6540,3745,0.7798165137614679,0.20718654434250763,0.5726299694189603
Kentucky,21067,Fayette County,58845,90566,152664,-31721,0.38545433108001886,0.5932374364617723,-0.20778310538175343
Kentucky,21069,Fleming County,5534,1474,7066,4060,0.7831870931219926,0.20860458533823945,0.5745825077837532
Kentucky,21071,Floyd County,12211,3855,16381,8356,0.7454367865209695,0.23533361821622611,0.5101031683047433
Kentucky,21073,Franklin County,12900,12650,26059,250,0.4950305076940788,0.4854368932038835,0.009593614490195301
Kentucky,21075,Fulton County,1605,791,2421,814,0.6629491945477075,0.3267244940107394,0.3362247005369681
Kentucky,21077,Gallatin County,2955,822,3849,2133,0.7677318784099766,0.21356196414653156,0.5541699142634451
Kentucky,21079,Garrard County,6754,1830,8703,4924,0.7760542341721246,0.21027231988969322,0.5657819142824314
Kentucky,21081,Grant County,8725,2205,11106,6520,0.7856113812353682,0.19854132901134522,0.587070052224023
Kentucky,21083,Graves County,13206,3559,17018,9647,0.7760018803619697,0.20913150781525444,0.5668703725467152
Kentucky,21085,Grayson County,9453,2400,11994,7053,0.788144072036018,0.2001000500250125,0.5880440220110055
Kentucky,21087,Green County,4838,920,5812,3918,0.8324156916724019,0.1582931865106676,0.6741225051617343
Kentucky,21089,Greenup County,13064,4873,18176,8191,0.71875,0.2681007922535211,0.4506492077464789
Kentucky,21091,Hancock County,3145,1351,4587,1794,0.6856333115325921,0.2945280139524744,0.3911052975801177
Kentucky,21093,Hardin County,29832,18101,48941,11731,0.6095502748207025,0.3698534970678981,0.23969677775280435
Kentucky,21095,Harlan County,9367,1494,10971,7873,0.8537963722541245,0.1361771944216571,0.7176191778324674
Kentucky,21097,Harrison County,6334,2400,8853,3934,0.7154636846266802,0.2710945442222975,0.4443691404043827
Kentucky,21099,Hart County,6345,1908,8369,4437,0.758155096188314,0.22798422750627315,0.5301708686820409
Kentucky,21101,Henderson County,12730,7639,20697,5091,0.6150649852635648,0.3690873073392279,0.2459776779243369
Kentucky,21103,Henry County,5843,2142,8107,3701,0.720735167139509,0.26421610953496977,0.45651905760453926
Kentucky,21105,Hickman County,1714,458,2199,1256,0.7794452023647113,0.20827648931332424,0.5711687130513871
Kentucky,21107,Hopkins County,15757,5439,21512,10318,0.7324748977314987,0.2528356266269989,0.4796392711044998
Kentucky,21109,Jackson County,5450,605,6116,4845,0.8911052975801177,0.09892086330935251,0.7921844342707651
Kentucky,21111,Jefferson County,150619,228288,386093,-77669,0.390110672817171,0.5912772311334316,-0.20116655831626057
Kentucky,21113,Jessamine County,17096,8567,26251,8529,0.6512513808997753,0.3263494724010514,0.3249019084987239
Kentucky,21115,Johnson County,8446,1607,10193,6839,0.8286078681448052,0.1576572157362896,0.6709506524085156
Kentucky,21117,Kenton County,48123,32265,82183,15858,0.5855590572259469,0.3925994427071292,0.1929596145188177
Kentucky,21119,Knott County,4779,1412,6251,3367,0.7645176771716525,0.22588385858262677,0.5386338185890258
Kentucky,21121,Knox County,11010,2111,13279,8899,0.8291286994502598,0.1589728142179381,0.6701558852323217
Kentucky,21123,Larue County,5685,1504,7301,4181,0.7786604574715792,0.20599917819476785,0.5726612792768113
Kentucky,21125,Laurel County,23234,4474,28097,18760,0.8269210235968253,0.1592340819304552,0.6676869416663701
Kentucky,21127,Lawrence County,5633,1238,6955,4395,0.809920920201294,0.17800143781452193,0.6319194823867721
Kentucky,21129,Lee County,2159,459,2659,1700,0.811959383226777,0.17262128619781872,0.6393380970289583
Kentucky,21131,Leslie County,4318,446,4814,3872,0.8969671790610719,0.09264644786040714,0.8043207312006648
Kentucky,21133,Letcher County,7226,1799,9148,5427,0.7898994315697421,0.19665500655881066,0.5932444250109314
Kentucky,21135,Lewis County,4986,823,5883,4163,0.847526772055074,0.1398946115927248,0.7076321604623492
Kentucky,21137,Lincoln County,8489,2254,10913,6235,0.7778795931457895,0.2065426555484285,0.5713369375973609
Kentucky,21139,Livingston County,4010,939,5003,3071,0.8015190885468719,0.18768738756745953,0.6138317009794124
Kentucky,21141,Logan County,9067,3094,12346,5973,0.7344079053944598,0.2506074842054107,0.4838004211890491
Kentucky,21143,Lyon County,3100,1092,4228,2008,0.7332071901608326,0.2582781456953642,0.47492904446546835
Kentucky,21145,McCracken County,21820,11190,33554,10630,0.6502950467902485,0.3334922810991238,0.3168027656911247
Kentucky,21147,McCreary County,5664,725,6435,4939,0.8801864801864802,0.11266511266511267,0.7675213675213675
Kentucky,21149,McLean County,3633,1074,4782,2559,0.759723964868256,0.2245922208281054,0.5351317440401506
Kentucky,21151,Madison County,27353,15580,43903,11773,0.6230325945835137,0.3548732432863358,0.2681593512971779
Kentucky,21153,Magoffin County,4174,1213,5446,2961,0.7664340800587587,0.22273228057289754,0.5437017994858612
Kentucky,21155,Marion County,6113,2722,8928,3391,0.6846998207885304,0.3048835125448029,0.37981630824372753
Kentucky,21157,Marshall County,13297,4071,17609,9226,0.7551252200579249,0.23118859674030326,0.5239366233176217
Kentucky,21159,Martin County,3496,403,3930,3093,0.8895674300254452,0.10254452926208651,0.7870229007633587
Kentucky,21161,Mason County,8908,3317,12394,5591,0.7187348717121188,0.26762949814426334,0.45110537356785546
Kentucky,21163,Meade County,10184,3632,14110,6552,0.7217576187101347,0.25740609496810773,0.46435152374202693
Kentucky,21165,Menifee County,2311,750,3102,1561,0.745003223726628,0.24177949709864605,0.503223726627982
Kentucky,21167,Mercer County,8506,3033,11735,5473,0.7248402215594376,0.2584576054537708,0.46638261610566684
Kentucky,21169,Metcalfe County,3957,973,5014,2984,0.7891902672516953,0.1940566414040686,0.5951336258476266
Kentucky,21171,Monroe County,4628,657,5330,3971,0.8682926829268293,0.12326454033771107,0.7450281425891182
Kentucky,21173,Montgomery County,8993,3630,12837,5363,0.7005530887278959,0.2827763496143959,0.4177767391135
Kentucky,21175,Morgan County,4297,1172,5535,3125,0.7763324299909665,0.211743450767841,0.5645889792231256
Kentucky,21177,Muhlenberg County,10496,3544,14229,6952,0.7376484644036826,0.24906880314849955,0.48857966125518304
Kentucky,21179,Nelson County,15703,7188,23256,8515,0.6752235982112144,0.3090815273477812,0.36614207086343314
Kentucky,21181,Nicholas County,2407,954,3396,1453,0.7087750294464076,0.28091872791519434,0.42785630153121323
Kentucky,21183,Ohio County,8582,2404,11127,6178,0.7712770737844882,0.21605104700278602,0.5552260267817022
Kentucky,21185,Oldham County,22651,14504,37936,8147,0.5970845634753269,0.3823281315900464,0.21475643188528049
Kentucky,21187,Owen County,4292,1098,5456,3194,0.7866568914956011,0.20124633431085043,0.5854105571847508
Kentucky,21189,Owsley County,1670,216,1895,1454,0.8812664907651715,0.11398416886543536,0.7672823218997361
Kentucky,21191,Pendleton County,5515,1322,6925,4193,0.7963898916967509,0.19090252707581226,0.6054873646209387
Kentucky,21193,Perry County,8118,2350,10606,5768,0.7654158023760136,0.22157269470111257,0.5438431076749011
Kentucky,21195,Pike County,20279,4862,25368,15417,0.79939293598234,0.19165878271838538,0.6077341532639546
Kentucky,21197,Powell County,3966,1281,5344,2685,0.7421407185628742,0.23970808383233533,0.5024326347305389
Kentucky,21199,Pulaski County,25441,5664,31537,19777,0.8067032374671022,0.17959856676285,0.6271046707042521
Kentucky,21201,Robertson County,884,253,1146,631,0.7713787085514834,0.22076788830715532,0.5506108202443281
Kentucky,21203,Rockcastle County,6577,1134,7784,5443,0.8449383350462487,0.14568345323741008,0.6992548818088387
Kentucky,21205,Rowan County,5994,3880,10058,2114,0.5959435275402665,0.3857625770530921,0.2101809504871744
Kentucky,21207,Russell County,7506,1329,8939,6177,0.839691240630943,0.1486743483611142,0.6910168922698288
Kentucky,21209,Scott County,17764,10564,28950,7200,0.6136096718480138,0.36490500863557856,0.24870466321243528
Kentucky,21211,Shelby County,15054,8076,23542,6978,0.6394528927024042,0.3430464701384759,0.29640642256392835
Kentucky,21213,Simpson County,5888,2681,8732,3207,0.674301420064132,0.3070316078790655,0.36726981218506644
Kentucky,21215,Spencer County,8737,2530,11429,6207,0.7644588327937702,0.22136669874879691,0.5430921340449734
Kentucky,21217,Taylor County,9376,2961,12510,6415,0.749480415667466,0.23669064748201438,0.5127897681854516
Kentucky,21219,Todd County,4060,1202,5351,2858,0.7587366847318259,0.22463091011025976,0.534105774621566
Kentucky,21221,Trigg County,5487,1791,7375,3696,0.744,0.24284745762711865,0.5011525423728813
Kentucky,21223,Trimble County,3227,1012,4319,2215,0.747163695299838,0.234313498495022,0.5128501968048159
Kentucky,21225,Union County,4965,1529,6576,3436,0.7550182481751825,0.23251216545012166,0.5225060827250608
Kentucky,21227,Warren County,31790,22477,55351,9313,0.5743347003667504,0.40608119094505973,0.16825350942169065
Kentucky,21229,Washington County,4482,1644,6223,2838,0.7202313996464728,0.26418126305640366,0.4560501365900691
Kentucky,21231,Wayne County,7430,1700,9240,5730,0.8041125541125541,0.18398268398268397,0.6201298701298701
Kentucky,21233,Webster County,4506,1412,5991,3094,0.7521281922884326,0.2356868636287765,0.5164413286596561
Kentucky,21235,Whitley County,12567,2552,15347,10015,0.8188571056232489,0.1662865706652766,0.6525705349579722
Kentucky,21237,Wolfe County,2097,837,2981,1260,0.7034552163703455,0.28077826232807784,0.4226769540422676
Kentucky,21239,Woodford County,8362,6530,15211,1832,0.5497337453158898,0.4292945894418513,0.12043915587403853
Louisiana,22001,Acadia Parish,22596,5443,28425,17153,0.794934036939314,0.19148636763412488,0.6034476693051891
Louisiana,22003,Allen Parish,7574,2108,9810,5466,0.7720693170234455,0.2148827726809378,0.5571865443425077
Louisiana,22005,Ascension Parish,40687,20399,62325,20288,0.6528198957079824,0.32730044123545926,0.3255194544725231
Louisiana,22007,Assumption Parish,7271,3833,11235,3438,0.6471740097908322,0.34116599910992434,0.3060080106809078
Louisiana,22009,Avoyelles Parish,12028,4979,17292,7049,0.6955817719176498,0.28793661808928983,0.40764515382836
Louisiana,22011,Beauregard Parish,13575,2542,16357,11033,0.8299199119642966,0.1554074708076053,0.6745124411566913
Louisiana,22013,Bienville Parish,3891,3066,7049,825,0.5519931905234785,0.43495531281032773,0.11703787771315077
Louisiana,22015,Bossier Parish,38065,15658,54642,22407,0.6966253065407562,0.28655612898502986,0.4100691775557263
Louisiana,22017,Caddo Parish,47927,54993,104699,-7066,0.4577598639910601,0.5252485697093573,-0.06748870571829718
Louisiana,22019,Calcasieu Parish,55066,25982,82663,29084,0.6661505147405732,0.3143123283694035,0.3518381863711697
Louisiana,22021,Caldwell Parish,3976,745,4762,3231,0.8349433011339773,0.15644687106257874,0.6784964300713986
Louisiana,22023,Cameron Parish,3671,324,4039,3347,0.9088883386976975,0.08021787571180986,0.8286704629858876
Louisiana,22025,Catahoula Parish,3541,1269,4858,2272,0.7289007822149033,0.2612186084808563,0.46768217373404697
Louisiana,22027,Claiborne Parish,3770,2731,6580,1039,0.5729483282674772,0.41504559270516717,0.15790273556231005
Louisiana,22029,Concordia Parish,5550,3177,8828,2373,0.6286814680561849,0.3598776619845945,0.2688038060715904
Louisiana,22031,De Soto Parish,9112,5457,14736,3655,0.6183496199782845,0.37031758957654726,0.24803203040173727
Louisiana,22033,East Baton Rouge Parish,88396,115533,208111,-27137,0.4247540975729298,0.5551508569945847,-0.13039675942165485
Louisiana,22035,East Carroll Parish,1080,1900,3036,-820,0.3557312252964427,0.6258234519104084,-0.27009222661396576
Louisiana,22037,East Feliciana Parish,6064,4280,10509,1784,0.5770292130554763,0.40726995908269104,0.16975925397278524
Louisiana,22039,Evangeline Parish,11053,4158,15412,6895,0.7171684401764858,0.2697897742019206,0.44737866597456527
Louisiana,22041,Franklin Parish,6970,2658,9720,4312,0.7170781893004116,0.2734567901234568,0.44362139917695476
Louisiana,22043,Grant Parish,8117,1157,9392,6960,0.8642461669505963,0.12318994889267462,0.7410562180579217
Louisiana,22045,Iberia Parish,21251,11027,32713,10224,0.649619417357014,0.33708311680371716,0.31253630055329684
Louisiana,22047,Iberville Parish,7893,8514,16719,-621,0.47209761349363,0.5092409833123991,-0.03714336981876909
Louisiana,22049,Jackson Parish,5394,2143,7632,3251,0.7067610062893082,0.28079140461215935,0.4259696016771488
Louisiana,22051,Jefferson Parish,105890,84438,193631,21452,0.5468649131595664,0.4360768678569031,0.11078804530266334
Louisiana,22053,Jefferson Davis Parish,11423,3208,14841,8215,0.7696920692675696,0.21615794083956608,0.5535341284280035
Louisiana,22055,Lafayette Parish,72519,39685,114521,32834,0.6332375721483396,0.346530330681709,0.2867072414666306
Louisiana,22057,Lafourche Parish,36024,8672,45388,27352,0.793689962104521,0.191063717282101,0.60262624482242
Louisiana,22059,LaSalle Parish,6348,574,6982,5774,0.9091950730449728,0.08221140074477228,0.8269836723002005
Louisiana,22061,Lincoln Parish,11311,7559,19275,3752,0.586822308690013,0.39216601815823604,0.1946562905317769
Louisiana,22063,Livingston Parish,54877,9249,65230,45628,0.8412846849609076,0.1417905871531504,0.6994940978077572
Louisiana,22065,Madison Parish,1930,2654,4670,-724,0.4132762312633833,0.5683083511777302,-0.15503211991434684
Louisiana,22067,Morehouse Parish,6510,4946,11574,1564,0.5624675997926387,0.42733713495766373,0.13513046483497498
Louisiana,22069,Natchitoches Parish,9358,6896,16554,2462,0.5653014377189803,0.41657605412589105,0.1487253835930893
Louisiana,22071,Orleans Parish,26645,147729,177670,-121084,0.14996904373276299,0.8314797095739292,-0.6815106658411663
Louisiana,22073,Ouachita Parish,42255,25913,69166,16342,0.6109215510510945,0.37464939421102855,0.23627215684006592
Louisiana,22075,Plaquemines Parish,7411,3413,11012,3998,0.6729930984380675,0.3099346167816927,0.36305848165637483
Louisiana,22077,Pointe Coupee Parish,7503,4683,12371,2820,0.6064990704065961,0.37854660092151,0.22795246948508613
Louisiana,22079,Rapides Parish,38346,19472,58861,18874,0.6514670155111194,0.33081327194577054,0.32065374356534887
Louisiana,22081,Red River Parish,2413,1644,4132,769,0.5839787028073572,0.3978702807357212,0.18610842207163597
Louisiana,22083,Richland Parish,6607,3225,9940,3382,0.6646881287726358,0.3244466800804829,0.34024144869215295
Louisiana,22085,Sabine Parish,8776,1731,10596,7045,0.8282370705926765,0.16336353340883353,0.664873537183843
Louisiana,22087,St. Bernard Parish,11178,6151,17649,5027,0.633350331463539,0.34851832965040513,0.2848320018131339
Louisiana,22089,St. Charles Parish,18233,9800,28517,8433,0.6393730055756216,0.34365466213136026,0.29571834344426134
Louisiana,22091,St. Helena Parish,2714,3346,6158,-632,0.4407275089314713,0.543358233192595,-0.10263072426112374
Louisiana,22093,St. James Parish,5954,6509,12589,-555,0.47295257764715226,0.5170386845658909,-0.0440861069187386
Louisiana,22095,St. John the Baptist Parish,7538,13581,21431,-6043,0.3517334702067099,0.6337081797396296,-0.28197470953291964
Louisiana,22097,St. Landry Parish,23171,17372,41154,5799,0.5630315400690091,0.4221217864606114,0.14090975360839775
Louisiana,22099,St. Martin Parish,18203,8439,27038,9764,0.6732376655078038,0.31211628078999926,0.3611213847178046
Louisiana,22101,St. Mary Parish,14811,8055,23186,6756,0.6387906495298887,0.3474079185715518,0.29138273095833694
Louisiana,22103,St. Tammany Parish,99666,37746,140110,61920,0.7113410891442438,0.2694026122332453,0.44193847691099847
Louisiana,22105,Tangipahoa Parish,37799,18883,57650,18916,0.6556634865568083,0.3275455333911535,0.3281179531656548
Louisiana,22107,Tensas Parish,1197,1329,2554,-132,0.46867658574784654,0.5203602192638997,-0.05168363351605321
Louisiana,22109,Terrebonne Parish,34339,11198,46240,23141,0.7426254325259516,0.24217128027681661,0.500454152249135
Louisiana,22111,Union Parish,8407,2654,11201,5753,0.7505579858941166,0.23694313007767165,0.513614855816445
Louisiana,22113,Vermilion Parish,21930,5009,27324,16921,0.8025911286780852,0.1833186941882594,0.6192724344898258
Louisiana,22115,Vernon Parish,14107,2898,17268,11209,0.8169446374797313,0.16782487838776927,0.6491197590919621
Louisiana,22117,Washington Parish,13307,5970,19513,7337,0.6819556193307026,0.30594987956746783,0.37600573976323476
Louisiana,22119,Webster Parish,11829,6172,18215,5657,0.6494098270656052,0.3388416140543508,0.3105682130112544
Louisiana,22121,West Baton Rouge Parish,7684,6200,14097,1484,0.5450805135844506,0.4398098886287863,0.10527062495566436
Louisiana,22123,West Carroll Parish,4317,710,5052,3607,0.8545130641330166,0.1405384006334125,0.7139746634996041
Louisiana,22125,West Feliciana Parish,3863,2298,6268,1565,0.6163050414805361,0.3666241225271219,0.2496809189534142
Louisiana,22127,Winn Parish,4617,1543,6223,3074,0.7419251165032942,0.2479511489635224,0.49397396753977174
Maine,23001,Androscoggin County,29259,27568,58770,1691,0.4978560490045942,0.46908286540752087,0.028773183597073315
Maine,23003,Aroostook County,19622,13318,33686,6304,0.5824971798373212,0.3953571216529122,0.18714005818440899
Maine,23005,Cumberland County,59491,128563,193945,-69072,0.30674160200056716,0.6628838072649462,-0.35614220526437906
Maine,23007,Franklin County,7169,6889,14635,280,0.4898530919029723,0.47072087461564743,0.019132217287324893
Maine,23009,Hancock County,13662,18412,33035,-4750,0.41356137429998485,0.5573482669895565,-0.14378689268957168
Maine,23011,Kennebec County,33801,33957,70029,-156,0.48267146467891875,0.4848991132245213,-0.002227648545602534
Maine,23013,Knox County,9870,14798,25303,-4928,0.39007232343990833,0.5848318381219618,-0.1947595146820535
Maine,23015,Lincoln County,9723,11807,22142,-2084,0.4391202240086713,0.533239996386957,-0.09411977237828567
Maine,23017,Oxford County,16860,14027,31884,2833,0.5287918705306737,0.4399385271609585,0.08885334336971518
Maine,23019,Penobscot County,39987,35267,77955,4720,0.5129497787184915,0.4524020268103393,0.06054775190815215
Maine,23021,Piscataquis County,5703,3273,9224,2430,0.6182784041630529,0.3548352124891587,0.2634431916738942
Maine,23023,Sagadahoc County,9755,13531,24042,-3776,0.4057482738540887,0.5628067548456868,-0.15705848099159808
Maine,23025,Somerset County,13915,8971,23529,4944,0.5913978494623656,0.3812741722980152,0.21012367716435043
Maine,23027,Waldo County,10939,12156,23905,-1217,0.457603011922192,0.5085128634176951,-0.05090985149550309
Maine,23029,Washington County,6657,4409,11346,2248,0.5867265996827076,0.3885950995945708,0.1981315000881368
Maine,23031,York County,54099,72363,130346,-18264,0.41504150491768066,0.5551608795053167,-0.14011937458763601
Maryland,24001,Allegany County,19939,8050,28419,11889,0.7016080791020092,0.2832611984939653,0.41834688060804387
Maryland,24003,Anne Arundel County,110684,133998,249413,-23314,0.44377799072221574,0.5372534711502608,-0.09347548042804504
Maryland,24005,Baltimore County,119305,177865,302247,-58560,0.39472682938126763,0.588475650709519,-0.19374882132825139
Maryland,24009,Calvert County,24786,21814,47463,2972,0.5222173061121295,0.4596001095590249,0.06261719655310455
Maryland,24011,Caroline County,9237,3572,13110,5665,0.7045766590389017,0.27246376811594203,0.4321128909229596
Maryland,24013,Carroll County,54176,29135,86188,25041,0.6285793846011045,0.338040098389567,0.2905392862115375
Maryland,24015,Cecil County,28257,15459,44672,12798,0.6325438753581661,0.3460556948424069,0.28648818051575925
Maryland,24017,Charles County,21419,42306,64714,-20887,0.3309793862224557,0.6537379855981704,-0.3227585993757147
Maryland,24019,Dorchester County,7804,5295,13371,2509,0.5836511854012415,0.3960062822526363,0.1876449031486052
Maryland,24021,Frederick County,57915,65506,126818,-7591,0.4566780740904288,0.5165355075777887,-0.059857433487359835
Maryland,24023,Garrett County,11654,3098,15045,8556,0.7746095048188767,0.2059155865736125,0.5686939182452642
Maryland,24025,Harford County,69468,43381,115796,26087,0.5999170955818854,0.3746329752323051,0.22528412034958034
Maryland,24027,Howard County,46442,122060,172813,-75618,0.268741356263707,0.7063126037971681,-0.4375712475334611
Maryland,24029,Kent County,4707,4830,9729,-123,0.4838112858464385,0.49645390070921985,-0.012642614862781343
Maryland,24031,Montgomery County,72888,265188,345549,-192300,0.21093390517697924,0.767439639530139,-0.5565057343531599
Maryland,24033,Prince George's County,32577,326546,365857,-293969,0.0890429867407211,0.8925509147016457,-0.8035079279609246
Maryland,24035,Queen Anne's County,18179,10209,28990,7970,0.6270783028630562,0.3521559158330459,0.2749223870300103
Maryland,24037,St. Mary's County,30245,22511,54097,7734,0.5590883043422001,0.4161228903636061,0.14296541397859402
Maryland,24039,Somerset County,5405,3542,9073,1863,0.595723575443624,0.390389066460928,0.20533450898269595
Maryland,24041,Talbot County,10524,10408,21305,116,0.4939685519831026,0.48852382069936634,0.005444731283736237
Maryland,24043,Washington County,38232,23448,62972,14784,0.6071269770691736,0.3723559677316903,0.23477100933748335
Maryland,24045,Wicomico County,21878,20150,42944,1728,0.509454172876304,0.46921572280178836,0.04023845007451565
Maryland,24047,Worcester County,15386,7898,23587,7488,0.6523084750074193,0.33484546572264384,0.31746300928477544
Maryland,24510,Baltimore city,20677,165350,189549,-144673,0.10908524972434569,0.8723338028689152,-0.7632485531445694
Massachusetts,25001,Barnstable County,54132,89732,146896,-35600,0.36850560941073957,0.6108539374795774,-0.24234832806883783
Massachusetts,25003,Berkshire County,14015,41521,56821,-27506,0.2466517660724028,0.730733355625561,-0.48408158955315816
Massachusetts,25005,Bristol County,118085,150063,274045,-31978,0.43089638563009725,0.5475852505975296,-0.11668886496743236
Massachusetts,25007,Dukes County,2587,9762,12587,-7175,0.2055295145785334,0.7755620878684357,-0.5700325732899023
Massachusetts,25009,Essex County,141135,259792,410009,-118657,0.34422415117716926,0.6336251155462441,-0.28940096436907486
Massachusetts,25011,Franklin County,5958,17148,23784,-11190,0.25050454086781027,0.7209889001009082,-0.47048435923309795
Massachusetts,25013,Hampden County,83816,122302,210828,-38486,0.39755630181949264,0.580103212097065,-0.1825469102775723
Massachusetts,25015,Hampshire County,21529,61288,84745,-39759,0.2540444864003776,0.7232049088441797,-0.46916042244380207
Massachusetts,25017,Middlesex County,223374,599370,842171,-375996,0.2652359200209934,0.7116963182061601,-0.4464603981851667
Massachusetts,25019,Nantucket County,1912,5234,7297,-3322,0.2620254899273674,0.7172810744141428,-0.4552555844867754
Massachusetts,25021,Norfolk County,116457,254647,379716,-138190,0.3066950036342951,0.6706248880742449,-0.36392988443994984
Massachusetts,25023,Plymouth County,111348,141665,259364,-30317,0.4293117009299672,0.5462014774602489,-0.11688977653028176
Massachusetts,25025,Suffolk County,55699,252661,314110,-196962,0.1773232307153545,0.8043710801948362,-0.6270478494794817
Massachusetts,25027,Worcester County,167250,241068,419569,-73818,0.3986233491988207,0.574561037636241,-0.1759376884374203
Michigan,26001,Alcona County,4848,2142,7063,2706,0.6863938836188589,0.30327056491575816,0.38312331870310073
Michigan,26003,Alger County,3014,2053,5135,961,0.586952288218111,0.3998052580331061,0.18714703018500484
Michigan,26005,Allegan County,41381,24447,67182,16934,0.6159536780685303,0.3638921139590962,0.2520615641094341
Michigan,26007,Alpena County,10686,6000,16966,4686,0.6298479311564306,0.35364847341742306,0.2761994577390075
Michigan,26009,Antrim County,9783,7289,17347,2494,0.5639591860264023,0.42018792874848676,0.1437712572779155
Michigan,26011,Arenac County,5928,2773,8830,3155,0.671347678369196,0.31404303510758774,0.3573046432616082
Michigan,26013,Baraga County,2512,1475,4033,1037,0.6228613935035954,0.3657327051822465,0.2571286883213489
Michigan,26015,Barry County,23473,11804,35914,11669,0.6535891295873476,0.3286740546861948,0.3249150749011528
Michigan,26017,Bay County,30919,21718,53505,9201,0.577871226988132,0.4059059900943837,0.17196523689374826
Michigan,26019,Benzie County,6600,5480,12259,1120,0.5383799657394567,0.44701851700791256,0.09136144873154411
Michigan,26021,Berrien County,43518,37438,82404,6080,0.5281054317751566,0.4543226056987525,0.07378282607640407
Michigan,26023,Branch County,14066,6161,20540,7905,0.6848101265822785,0.29995131450827656,0.3848588120740019
Michigan,26025,Calhoun County,35900,28417,65568,7483,0.5475231820400195,0.4333973889702294,0.1141257930697901
Michigan,26027,Cass County,16686,9122,26221,7564,0.6363601693299263,0.3478890965256855,0.28847107280424084
Michigan,26029,Charlevoix County,9841,6939,17023,2902,0.578100217352993,0.40762497797098046,0.17047523938201253
Michigan,26031,Cheboygan County,10171,5435,15849,4736,0.6417439586093759,0.3429238437756325,0.29882011483374343
Michigan,26033,Chippewa County,10682,6651,17675,4031,0.6043564356435643,0.3762942008486563,0.22806223479490806
Michigan,26035,Clare County,10860,5200,16280,5660,0.6670761670761671,0.3194103194103194,0.34766584766584774
Michigan,26037,Clinton County,25095,21963,47902,3132,0.5238820926057367,0.45849860131101,0.0653834912947267
Michigan,26039,Crawford County,4955,2612,7665,2343,0.6464448793215917,0.3407697325505545,0.3056751467710372
Michigan,26041,Delta County,13206,7605,21154,5601,0.624279096152028,0.3595064763165359,0.26477261983549216
Michigan,26043,Dickinson County,8469,4569,13268,3900,0.6383026831474223,0.34436237564063915,0.2939403075067832
Michigan,26045,Eaton County,31797,31297,64451,500,0.49335153837799256,0.4855937068470621,0.007757831530930459
Michigan,26047,Emmet County,12135,9662,22176,2473,0.5472132034632035,0.4356962481962482,0.11151695526695526
Michigan,26049,Genesee County,99199,120082,222969,-20883,0.44490041216491977,0.5385591719028205,-0.09365875973790078
Michigan,26051,Gladwin County,9893,4524,14603,5369,0.677463534890091,0.3097993562966514,0.36766417859343964
Michigan,26053,Gogebic County,4600,3573,8279,1027,0.5556226597415147,0.43157386157748523,0.12404879816402947
Michigan,26055,Grand Traverse County,30502,28682,60226,1820,0.5064590044166971,0.4762394978912762,0.030219506525420936
Michigan,26057,Gratiot County,12102,6693,19148,5409,0.6320242322958012,0.3495404219761855,0.28248381031961567
Michigan,26059,Hillsdale County,17037,5883,23288,11154,0.7315784953624184,0.25261937478529717,0.4789591205771212
Michigan,26061,Houghton County,10380,7755,18540,2625,0.5598705501618123,0.41828478964401294,0.14158576051779936
Michigan,26063,Huron County,11949,5349,17523,6600,0.6819037835986989,0.30525594932374595,0.3766478342749529
Michigan,26065,Ingham County,47640,94221,144797,-46581,0.3290123414159133,0.6507109953935509,-0.32169865397763764
Michigan,26067,Ionia County,20655,10899,32201,9756,0.6414397068414024,0.3384677494487749,0.3029719573926275
Michigan,26069,Iosco County,9760,5371,15386,4389,0.6343429091381776,0.34908358247757704,0.28525932666060055
Michigan,26071,Iron County,4216,2493,6795,1723,0.6204562178072112,0.36688741721854307,0.2535688005886681
Michigan,26073,Isabella County,14815,14072,29409,743,0.5037573531912,0.47849297833996396,0.025264374851236004
Michigan,26075,Jackson County,47381,32004,81032,15377,0.5847196169414552,0.3949550794747754,0.18976453746667987
Michigan,26077,Kalamazoo County,56823,83674,143640,-26851,0.39559314954051794,0.5825257588415483,-0.1869326093010304
Michigan,26079,Kalkaska County,7436,3003,10627,4433,0.6997271101910228,0.28258210219252844,0.4171450079984944
Michigan,26081,Kent County,165318,186753,359915,-21435,0.4593251184307406,0.5188808468666213,-0.059555728435880695
Michigan,26083,Keweenaw County,862,672,1557,190,0.5536287732819525,0.43159922928709055,0.12202954399486193
Michigan,26085,Lake County,3946,2288,6332,1658,0.6231838281743525,0.361339229311434,0.2618445988629185
Michigan,26087,Lapeer County,35480,16368,52639,19112,0.6740249624802903,0.3109481563099603,0.36307680617033
Michigan,26089,Leelanau County,7915,8793,16930,-878,0.46751329001772,0.5193738924985233,-0.051860602480803264
Michigan,26091,Lenawee County,31539,20916,53448,10623,0.5900875617422542,0.3913336326897171,0.19875392905253708
Michigan,26093,Livingston County,76980,48218,127162,28762,0.6053695286327676,0.37918560576272786,0.22618392287003974
Michigan,26095,Luce County,2109,842,3107,1267,0.6787898294174445,0.271000965561635,0.4077888638558095
Michigan,26097,Mackinac County,4258,2589,6922,1669,0.6151401329095637,0.3740248483097371,0.24111528459982662
Michigan,26099,Macomb County,264535,225561,496523,38974,0.5327749167712271,0.45428107056470696,0.07849384620652017
Michigan,26101,Manistee County,8321,6107,14654,2214,0.5678313088576498,0.4167462808789409,0.15108502797870887
Michigan,26103,Marquette County,16288,20465,37553,-4177,0.43373365643224243,0.5449631187921071,-0.1112294623598647
Michigan,26105,Mason County,10207,6802,17249,3405,0.5917444489535625,0.39434170096817206,0.19740274798539043
Michigan,26107,Mecosta County,13265,7373,21077,5892,0.6293590169378944,0.349812591924847,0.27954642501304744
Michigan,26109,Menominee County,8120,4314,12622,3806,0.6433211852321343,0.3417841863413088,0.3015369988908255
Michigan,26111,Midland County,27706,20513,49165,7193,0.5635309671514288,0.4172277026339876,0.1463032645174412
Michigan,26113,Missaukee County,6648,1967,8755,4681,0.7593375214163335,0.22467161621930326,0.5346659051970302
Michigan,26115,Monroe County,52710,32975,87223,19735,0.6043130825584995,0.37805395365901195,0.22625912889948752
Michigan,26117,Montcalm County,21815,9703,32086,12112,0.6798915414822664,0.30240603378420494,0.37748550769806144
Michigan,26119,Montmorency County,4171,1628,5863,2543,0.7114105406788334,0.2776735459662289,0.43373699471260446
Michigan,26121,Muskegon County,44544,45508,91701,-964,0.4857526090228024,0.496265035277696,-0.010512426254893625
Michigan,26123,Newaygo County,18864,7874,27164,10990,0.6944485348255044,0.2898689441908408,0.4045795906346636
Michigan,26125,Oakland County,328313,438147,778418,-109834,0.4217695377033933,0.5628685359279976,-0.14109899822460426
Michigan,26127,Oceana County,8892,4944,14080,3948,0.631534090909091,0.35113636363636364,0.2803977272727273
Michigan,26129,Ogemaw County,8253,3475,11907,4778,0.6931216931216931,0.2918451331149744,0.40127656000671874
Michigan,26131,Ontonagon County,2358,1391,3810,967,0.6188976377952756,0.36509186351706036,0.25380577427821527
Michigan,26133,Osceola County,8928,3214,12340,5714,0.7235008103727715,0.26045380875202595,0.4630470016207455
Michigan,26135,Oscoda County,3466,1342,4874,2124,0.7111202297907263,0.275338530980714,0.43578169881001233
Michigan,26137,Otsego County,9779,4743,14756,5036,0.6627134724857685,0.32142857142857145,0.34128490105719705
Michigan,26139,Ottawa County,100511,64566,168074,35945,0.5980163499410974,0.3841522186655878,0.21386413127550963
Michigan,26141,Presque Isle County,5343,2912,8360,2431,0.6391148325358852,0.34832535885167465,0.29078947368421054
Michigan,26143,Roscommon County,9670,5166,15018,4504,0.6438939938740178,0.3439872153415901,0.2999067785324277
Michigan,26145,Saginaw County,50785,51088,103347,-303,0.4914027499588764,0.4943346202599011,-0.0029318703010247082
Michigan,26147,St. Clair County,59185,31363,92063,27822,0.6428749877801071,0.3406688897819971,0.30220609799811
Michigan,26149,St. Joseph County,18128,9262,27982,8866,0.6478450432420843,0.330998499035094,0.31684654420699027
Michigan,26151,Sanilac County,16194,5966,22446,10228,0.7214648489708634,0.26579345985921765,0.45567138911164573
Michigan,26153,Schoolcraft County,3090,1589,4745,1501,0.6512118018967334,0.33487881981032663,0.3163329820864068
Michigan,26155,Shiawassee County,23154,15371,39250,7783,0.5899108280254777,0.39161783439490444,0.19829299363057323
Michigan,26157,Tuscola County,20310,8713,29495,11597,0.6885912866587557,0.29540600101712156,0.39318528564163413
Michigan,26159,Van Buren County,21591,16800,39060,4791,0.5527649769585253,0.43010752688172044,0.1226574500768049
Michigan,26161,Washtenaw County,56241,157130,216924,-100889,0.25926591801737014,0.7243550736663532,-0.46508915564898307
Michigan,26163,Wayne County,264149,587074,863382,-322925,0.3059468462395556,0.6799701638440458,-0.37402331760449026
Michigan,26165,Wexford County,12102,5838,18292,6264,0.6616006997594577,0.31915591515416575,0.34244478460529193
Minnesota,27001,Aitkin County,6256,3604,10005,2652,0.6252873563218391,0.3602198900549725,0.26506746626686656
Minnesota,27003,Anoka County,104851,100832,210975,4019,0.49698305486432043,0.4779334044318047,0.01904965043251572
Minnesota,27005,Becker County,12452,6592,19471,5860,0.6395151764162087,0.3385547737661137,0.300960402650095
Minnesota,27007,Beltrami County,12181,11424,24121,757,0.504995646946644,0.4736122051324572,0.031383441814186785
Minnesota,27009,Benton County,14375,7280,22211,7095,0.6472018369276484,0.32776552158840216,0.31943631533924627
Minnesota,27011,Big Stone County,1862,1052,2972,810,0.626514131897712,0.35397039030955585,0.27254374158815614
Minnesota,27013,Blue Earth County,16721,18319,36027,-1598,0.4641241291253782,0.5084797512976379,-0.04435562217225969
Minnesota,27015,Brown County,9548,4745,14623,4803,0.6529439923408329,0.32448881898379267,0.3284551733570402
Minnesota,27017,Carlton County,9787,10094,20361,-307,0.48067383723785667,0.4957516821374196,-0.015077844899562931
Minnesota,27019,Carver County,34006,30761,66104,3245,0.514431804429384,0.4653424906208399,0.04908931380854409
Minnesota,27021,Cass County,11619,6339,18251,5280,0.6366226508136541,0.34732343433236534,0.28929921648128876
Minnesota,27023,Chippewa County,4250,2226,6611,2024,0.6428679473604598,0.3367115413704432,0.30615640599001664
Minnesota,27025,Chisago County,21909,11798,34513,10111,0.6348042766493784,0.34184220438675283,0.2929620722626256
Minnesota,27027,Clay County,15031,16345,32215,-1314,0.4665838894924724,0.5073723420766724,-0.04078845258419994
Minnesota,27029,Clearwater County,3371,1258,4705,2113,0.7164718384697131,0.267375132837407,0.4490967056323061
Minnesota,27031,Cook County,1202,2494,3786,-1292,0.31748547279450606,0.658742736397253,-0.34125726360274694
Minnesota,27033,Cottonwood County,4164,1834,6095,2330,0.6831829368334701,0.30090237899917965,0.38228055783429044
Minnesota,27035,Crow Wing County,25668,13723,40160,11945,0.6391434262948207,0.34170816733067727,0.2974352589641434
Minnesota,27037,Dakota County,109033,145206,260665,-36173,0.41828784071509406,0.5570598277482592,-0.13877198703316518
Minnesota,27039,Dodge County,8574,4074,12953,4500,0.6619315988574076,0.31452173241720066,0.34740986644020694
Minnesota,27041,Douglas County,15790,7864,24106,7926,0.6550236455654194,0.3262258358914793,0.32879780967394007
Minnesota,27043,Faribault County,5186,2529,7885,2657,0.6577045022194039,0.3207355738744451,0.3369689283449588
Minnesota,27045,Fillmore County,7298,4551,12136,2747,0.6013513513513513,0.375,0.22635135135135132
Minnesota,27047,Freeborn County,9578,6889,16813,2689,0.5696782251828942,0.40974246119074526,0.15993576399214898
Minnesota,27049,Goodhue County,16052,11802,28563,4250,0.561985785806813,0.4131918916080244,0.14879389419878863
Minnesota,27051,Grant County,2267,1299,3647,968,0.6216068001096792,0.35618316424458457,0.2654236358650946
Minnesota,27053,Hennepin County,205877,532373,753716,-326496,0.2731493029204634,0.7063310318475394,-0.433181728927076
Minnesota,27055,Houston County,6332,4851,11435,1481,0.5537385220813292,0.42422387407083517,0.12951464801049406
Minnesota,27057,Hubbard County,8202,4462,12927,3740,0.6344859596194012,0.34516902606946703,0.2893169335499342
Minnesota,27059,Isanti County,16491,7138,24162,9353,0.6825180034765334,0.29542256435725517,0.3870954391192782
Minnesota,27061,Itasca County,15232,10784,26502,4448,0.5747490755414686,0.4069126858350313,0.16783638970643727
Minnesota,27063,Jackson County,3945,1744,5809,2201,0.6791186090549148,0.30022379066965055,0.3788948183852643
Minnesota,27065,Kanabec County,6276,2773,9234,3503,0.6796621182586094,0.300303227203812,0.3793588910547975
Minnesota,27067,Kandiyohi County,14433,8434,23301,5999,0.6194154757306554,0.3619587142182739,0.25745676151238145
Minnesota,27069,Kittson County,1545,1006,2638,539,0.5856709628506445,0.3813495072024261,0.20432145564821835
Minnesota,27071,Koochiching County,4131,2657,6920,1474,0.5969653179190751,0.3839595375722543,0.21300578034682083
Minnesota,27073,Lac qui Parle County,2527,1445,4039,1082,0.6256499133448874,0.35776182223322606,0.26788809111166134
Minnesota,27075,Lake County,3392,3646,7200,-254,0.4711111111111111,0.5063888888888889,-0.0352777777777778
Minnesota,27077,Lake of the Woods County,1704,671,2405,1033,0.7085239085239086,0.279002079002079,0.42952182952182955
Minnesota,27079,Le Sueur County,10774,5669,16772,5105,0.6423801574051992,0.33800381588361555,0.3043763415215836
Minnesota,27081,Lincoln County,2120,937,3114,1183,0.680796403339756,0.3008991650610148,0.3798972382787412
Minnesota,27083,Lyon County,7975,4624,12877,3351,0.6193212704822552,0.35908985012036965,0.2602314203618855
Minnesota,27085,McLeod County,13982,6410,20909,7572,0.6687072552489358,0.3065665502893491,0.3621407049595867
Minnesota,27087,Mahnomen County,1142,1110,2302,32,0.49609035621198955,0.48218940052128584,0.013900955690703709
Minnesota,27089,Marshall County,3716,1293,5093,2423,0.7296289024150795,0.25387787158845476,0.47575103082662473
Minnesota,27091,Martin County,7476,3304,11038,4172,0.677296611705019,0.29932958869360393,0.37796702301141505
Minnesota,27093,Meeker County,9352,3865,13493,5487,0.6931001259912547,0.28644482324168086,0.40665530274957384
Minnesota,27095,Mille Lacs County,9948,4401,14658,5547,0.6786737617683176,0.3002455996725338,0.37842816209578384
Minnesota,27097,Morrison County,14815,4365,19517,10450,0.7590818261003228,0.22365117589793512,0.5354306502023877
Minnesota,27099,Mower County,10067,8997,19441,1070,0.5178231572449977,0.4627848361709789,0.05503832107401885
Minnesota,27101,Murray County,3362,1449,4882,1913,0.688652191724703,0.2968045882834904,0.39184760344121267
Minnesota,27103,Nicollet County,9016,9619,19118,-603,0.4715974474317397,0.5031384035987028,-0.03154095616696306
Minnesota,27105,Nobles County,5598,2928,8708,2670,0.6428571428571429,0.3362425355994488,0.3066146072576941
Minnesota,27107,Norman County,1954,1404,3434,550,0.569015725101922,0.40885264997087944,0.16016307513104255
Minnesota,27109,Olmsted County,39687,49486,91074,-9799,0.4357665195335661,0.5433603443353756,-0.10759382480180951
Minnesota,27111,Otter Tail County,23794,11940,36372,11854,0.6541845375563621,0.3282744968657209,0.32591004069064117
Minnesota,27113,Pennington County,4532,2567,7262,1965,0.6240705039933903,0.35348388873588543,0.2705866152575048
Minnesota,27115,Pine County,10256,5416,15998,4840,0.6410801350168771,0.3385423177897237,0.3025378172271534
Minnesota,27117,Pipestone County,3553,1306,4932,2247,0.7203974047039741,0.26480129764801297,0.4555961070559611
Minnesota,27119,Polk County,9857,5435,15581,4422,0.6326294846287145,0.3488222835504782,0.2838072010782363
Minnesota,27121,Pope County,4413,2478,7019,1935,0.6287220401766633,0.35304174383815357,0.27568029633850977
Minnesota,27123,Ramsey County,77323,211357,294507,-134034,0.26255063546876645,0.7176637567188556,-0.4551131212500892
Minnesota,27125,Red Lake County,1450,689,2190,761,0.6621004566210046,0.31461187214611874,0.34748858447488584
Minnesota,27127,Redwood County,5775,2358,8290,3417,0.6966224366706876,0.28443908323281064,0.41218335343787693
Minnesota,27129,Renville County,5465,2497,8115,2968,0.6734442390634627,0.30770178681454097,0.36574245224892177
Minnesota,27131,Rice County,17455,17386,35582,69,0.4905570232139846,0.48861784048114215,0.0019391827328424371
Minnesota,27133,Rock County,3578,1554,5232,2024,0.683868501529052,0.29701834862385323,0.38685015290519875
Minnesota,27135,Roseau County,6053,2182,8390,3871,0.7214541120381407,0.2600715137067938,0.46138259833134687
Minnesota,27137,St. Louis County,49214,67836,119859,-18622,0.4105991206334109,0.5659650088854404,-0.15536588825202952
Minnesota,27139,Scott County,45840,40007,87664,5833,0.5229056397152765,0.4563674940682606,0.06653814564701588
Minnesota,27141,Sherburne County,36205,18056,55456,18149,0.6528599249855741,0.32559145989613386,0.32726846508944024
Minnesota,27143,Sibley County,5864,2417,8451,3447,0.6938823807833393,0.2860016566086854,0.40788072417465393
Minnesota,27145,Stearns County,50960,31883,84647,19077,0.602029605302019,0.3766583576500053,0.22537124765201366
Minnesota,27147,Steele County,12656,7916,21125,4740,0.5991005917159763,0.3747218934911243,0.224378698224852
Minnesota,27149,Stevens County,3045,1921,5063,1124,0.6014220817697018,0.3794193166107051,0.2220027651589967
Minnesota,27151,Swift County,3316,1784,5185,1532,0.6395371263259402,0.344069431051109,0.2954676952748312
Minnesota,27153,Todd County,9755,3286,13238,6469,0.7368937906028101,0.2482248073727149,0.4886689832300952
Minnesota,27155,Traverse County,1173,662,1864,511,0.6292918454935622,0.3551502145922747,0.2741416309012875
Minnesota,27157,Wabasha County,8149,4691,13088,3458,0.6226314180929096,0.35841992665036676,0.2642114914425428
Minnesota,27159,Wadena County,5517,2021,7656,3496,0.7206112852664577,0.2639759665621735,0.4566353187042842
Minnesota,27161,Waseca County,6623,3494,10386,3129,0.637685345657616,0.33641440400539185,0.3012709416522242
Minnesota,27163,Washington County,73749,89136,166222,-15387,0.44367773218948153,0.5362467062121741,-0.09256897402269254
Minnesota,27165,Watonwan County,3103,1987,5191,1116,0.5977653631284916,0.3827778848006165,0.21498747832787513
Minnesota,27167,Wilkin County,2333,1027,3435,1306,0.6791848617176128,0.298981077147016,0.38020378457059684
Minnesota,27169,Winona County,13227,13330,27105,-103,0.48799114554510237,0.49179118243866443,-0.0038000368935620643
Minnesota,27171,Wright County,53565,30854,86535,22711,0.6189980932570636,0.35654937308603457,0.262448720171029
Minnesota,27173,Yellow Medicine County,3734,1685,5525,2049,0.6758371040723982,0.3049773755656109,0.3708597285067873
Mississippi,28001,Adams County,5222,6914,12268,-1692,0.42566025432018256,0.5635800456472123,-0.13791979132702975
Mississippi,28003,Alcorn County,12689,2741,15639,9948,0.8113690133640258,0.1752669608031204,0.6361020525609054
Mississippi,28005,Amite County,3781,2114,5974,1667,0.6329092735185805,0.3538667559424171,0.2790425175761634
Mississippi,28007,Attala County,5178,3542,8832,1636,0.5862771739130435,0.4010416666666667,0.18523550724637677
Mississippi,28009,Benton County,2553,1661,4257,892,0.5997181113460183,0.39018087855297157,0.2095372327930467
Mississippi,28011,Bolivar County,4260,7203,11631,-2943,0.3662625741552747,0.6192932679907145,-0.2530306938354398
Mississippi,28013,Calhoun County,4592,1878,6536,2714,0.7025703794369645,0.28733170134638925,0.4152386780905753
Mississippi,28015,Carroll County,3257,1203,4509,2054,0.7223331115546684,0.26679973386560213,0.45553337768906627
Mississippi,28017,Chickasaw County,4173,3808,8143,365,0.5124646936018666,0.46764091858037576,0.044823775021490875
Mississippi,28019,Choctaw County,2971,1170,4175,1801,0.7116167664670658,0.28023952095808385,0.431377245508982
Mississippi,28021,Claiborne County,479,2337,2886,-1858,0.16597366597366597,0.8097713097713097,-0.6437976437976438
Mississippi,28023,Clarke County,5372,2815,8277,2557,0.6490274253956747,0.34009906971124804,0.30892835568442667
Mississippi,28025,Clay County,4147,5728,10054,-1581,0.412472647702407,0.5697234931370598,-0.15725084543465284
Mississippi,28027,Coahoma County,1846,5189,7136,-3343,0.2586883408071749,0.7271580717488789,-0.468469730941704
Mississippi,28029,Copiah County,5407,5227,10800,180,0.5006481481481482,0.48398148148148146,0.01666666666666672
Mississippi,28031,Covington County,5811,3382,9294,2429,0.6252420916720465,0.36389068216053366,0.2613514095115128
Mississippi,28033,DeSoto County,45788,27733,75013,18055,0.6104008638502659,0.3697092503965979,0.24069161345366802
Mississippi,28035,Forrest County,15326,10603,26540,4723,0.5774679728711379,0.3995101733232856,0.17795779954785235
Mississippi,28037,Franklin County,2894,1476,4431,1418,0.6531257052584066,0.33310765064319564,0.320018054615211
Mississippi,28039,George County,9602,1208,10940,8394,0.8776965265082267,0.11042047531992688,0.7672760511882999
Mississippi,28041,Greene County,4740,952,5748,3788,0.824634655532359,0.16562282533054976,0.6590118302018093
Mississippi,28043,Grenada County,4889,2866,7838,2023,0.6237560602194437,0.36565450369992347,0.25810155651952027
Mississippi,28045,Hancock County,13999,3095,17403,10904,0.8044015399643739,0.17784290064931332,0.6265586393150606
Mississippi,28047,Harrison County,41281,18499,60941,22782,0.6773928882033442,0.3035558983278909,0.3738369898754533
Mississippi,28049,Hinds County,21242,59192,81811,-37950,0.2596472357018005,0.723521286868514,-0.46387405116671354
Mississippi,28051,Holmes County,1196,5182,6542,-3986,0.18281870987465607,0.7921125038214614,-0.6092937939468053
Mississippi,28053,Humphreys County,1115,2994,4164,-1879,0.26777137367915466,0.7190201729106628,-0.4512487992315081
Mississippi,28055,Issaquena County,308,355,676,-47,0.4556213017751479,0.5251479289940828,-0.06952662721893488
Mississippi,28057,Itawamba County,9374,1230,10743,8144,0.8725681839337243,0.11449315833566043,0.7580750255980638
Mississippi,28059,Jackson County,32563,12061,45486,20502,0.715890603702238,0.2651585103108649,0.4507320933913731
Mississippi,28061,Jasper County,4256,4287,8642,-31,0.4924785929183059,0.49606572552649847,-0.0035871326081925448
Mississippi,28063,Jefferson County,529,3325,3907,-2796,0.135398003583312,0.8510366009726132,-0.7156385973893012
Mississippi,28065,Jefferson Davis County,1927,2645,4650,-718,0.41440860215053765,0.5688172043010753,-0.15440860215053764
Mississippi,28067,Jones County,19130,7017,26492,12113,0.7221047863505964,0.2648724143137551,0.4572323720368413
Mississippi,28069,Kemper County,1609,2275,3935,-666,0.4088945362134689,0.5781448538754765,-0.16925031766200765
Mississippi,28071,Lafayette County,9878,6904,17163,2974,0.5755404066888073,0.40226067703781393,0.17327972965099342
Mississippi,28073,Lamar County,20406,7205,28082,13201,0.7266576454668471,0.2565700448685991,0.470087600598248
Mississippi,28075,Lauderdale County,17812,12668,30811,5144,0.5781052221609165,0.4111518613482198,0.16695336081269674
Mississippi,28077,Lawrence County,4254,2240,6564,2014,0.6480804387568556,0.34125533211456427,0.30682510664229135
Mississippi,28079,Leake County,4973,3358,8407,1615,0.5915308671345307,0.3994290472225526,0.1921018199119781
Mississippi,28081,Lee County,21297,9910,31762,11387,0.6705182293306466,0.31200805994584724,0.3585101693847994
Mississippi,28083,Leflore County,2623,5444,8178,-2821,0.3207385668867694,0.6656884323795549,-0.3449498654927855
Mississippi,28085,Lincoln County,10107,3978,14247,6129,0.7094125078963992,0.279216677195199,0.4301958307012002
Mississippi,28087,Lowndes County,13699,12913,26993,786,0.5075019449486904,0.4783832845552551,0.029118660393435303
Mississippi,28089,Madison County,26188,18931,45832,7257,0.5713911677430616,0.413052016058649,0.15833915168441265
Mississippi,28091,Marion County,7783,3421,11338,4362,0.6864526371494091,0.3017286999470806,0.38472393720232845
Mississippi,28093,Marshall County,6591,6283,13064,308,0.5045162278015921,0.48093998775260255,0.02357624004898956
Mississippi,28095,Monroe County,9677,4565,14461,5112,0.6691791715648987,0.3156766475347486,0.3535025240301501
Mississippi,28097,Montgomery County,2866,2084,4972,782,0.5764279967819791,0.41914722445695896,0.15728077232502014
Mississippi,28099,Neshoba County,8311,3247,11698,5064,0.7104633270644555,0.27756881518208243,0.43289451188237305
Mississippi,28101,Newton County,6037,2542,8678,3495,0.6956672044249828,0.29292463701313665,0.4027425674118461
Mississippi,28103,Noxubee County,1057,2867,3981,-1810,0.2655111780959558,0.7201708113539311,-0.4546596332579753
Mississippi,28105,Oktibbeha County,8972,10257,19737,-1285,0.4545776967117596,0.5196838425292598,-0.06510614581750018
Mississippi,28107,Panola County,7976,7276,15421,700,0.5172167823098373,0.4718241359185526,0.04539264639128465
Mississippi,28109,Pearl River County,19283,4068,23656,15215,0.8151420358471424,0.17196482921880285,0.6431772066283395
Mississippi,28111,Perry County,4426,1340,5825,3086,0.7598283261802575,0.23004291845493563,0.5297854077253219
Mississippi,28113,Pike County,7106,7328,14640,-222,0.48538251366120216,0.5005464480874317,-0.015163934426229486
Mississippi,28115,Pontotoc County,11425,2580,14215,8845,0.8037284558564897,0.1814984171649666,0.622230038691523
Mississippi,28117,Prentiss County,8274,2128,10539,6146,0.785083973811557,0.20191669038808235,0.5831672834234747
Mississippi,28119,Quitman County,1020,2138,3211,-1118,0.3176580504515727,0.6658361881033946,-0.34817813765182193
Mississippi,28121,Rankin County,39025,13496,53400,25529,0.7308052434456929,0.25273408239700373,0.47807116104868913
Mississippi,28123,Scott County,5688,3575,9386,2113,0.6060089494992542,0.3808864265927978,0.2251225229064564
Mississippi,28125,Sharkey County,687,1440,2157,-753,0.3184979137691238,0.6675938803894298,-0.349095966620306
Mississippi,28127,Simpson County,6552,3384,10066,3168,0.650904033379694,0.3361812040532486,0.31472282932644546
Mississippi,28129,Smith County,5697,1518,7285,4179,0.7820178448867536,0.20837336993822925,0.5736444749485243
Mississippi,28131,Stone County,5239,1208,6546,4031,0.8003360831041858,0.18454017720745494,0.6157959058967308
Mississippi,28133,Sunflower County,2361,5118,7568,-2757,0.31197145877378435,0.6762684989429175,-0.36429704016913317
Mississippi,28135,Tallahatchie County,2228,2636,4956,-408,0.4495560936238902,0.5318805488297014,-0.08232445520581116
Mississippi,28137,Tate County,5529,2744,8420,2785,0.6566508313539192,0.32589073634204274,0.3307600950118765
Mississippi,28139,Tippah County,7987,1906,10001,6081,0.7986201379862014,0.19058094190580943,0.6080391960803919
Mississippi,28141,Tishomingo County,7854,1050,9057,6804,0.8671745611129513,0.11593242795627691,0.7512421331566744
Mississippi,28143,Tunica County,912,2525,3494,-1613,0.2610188895248998,0.7226674298797939,-0.4616485403548941
Mississippi,28145,Union County,9052,1792,10989,7260,0.8237328237328237,0.16307216307216307,0.6606606606606606
Mississippi,28147,Walthall County,0,0,0,0,NaN,NaN,NaN
Mississippi,28149,Warren County,10236,10681,21162,-445,0.4836971930819393,0.5047254512805973,-0.021028258198658
Mississippi,28151,Washington County,4114,6218,10514,-2104,0.39128780673387864,0.591401940270116,-0.20011413353623742
Mississippi,28153,Wayne County,6264,3592,9988,2672,0.6271525830997197,0.35963155786944334,0.2675210252302763
Mississippi,28155,Webster County,4255,1024,5347,3231,0.7957733308397232,0.19150925752758557,0.6042640733121376
Mississippi,28157,Wilkinson County,1188,2364,3606,-1176,0.32945091514143093,0.6555740432612313,-0.3261231281198003
Mississippi,28159,Winston County,5084,4009,9184,1075,0.5535714285714286,0.43652003484320556,0.11705139372822304
Mississippi,28161,Yalobusha County,3658,2767,6506,891,0.5622502305564094,0.42529972333230864,0.1369505072241008
Mississippi,28163,Yazoo County,4370,4533,9012,-163,0.48490901020861077,0.5029960053262317,-0.018086995117620908
Missouri,29001,Adair County,6391,3705,10337,2686,0.6182644867950082,0.35842120537873656,0.25984328141627167
Missouri,29003,Andrew County,7255,2351,9774,4904,0.7422754245958666,0.24053611622672397,0.5017393083691426
Missouri,29005,Atchison County,2199,564,2814,1635,0.7814498933901919,0.20042643923240938,0.5810234541577826
Missouri,29007,Audrain County,7727,2703,10660,5024,0.724859287054409,0.25356472795497187,0.4712945590994372
Missouri,29009,Barry County,12425,2948,15616,9477,0.7956582991803278,0.18878073770491804,0.6068775614754098
Missouri,29011,Barton County,5168,844,6077,4324,0.850419614941583,0.13888431792002634,0.7115352970215567
Missouri,29013,Bates County,6595,1672,8435,4923,0.7818612922347362,0.198221695317131,0.5836395969176053
Missouri,29015,Benton County,8106,2179,10478,5927,0.7736209200229052,0.2079595342622638,0.5656613857606414
Missouri,29017,Bollinger County,5162,749,5981,4413,0.8630663768600568,0.12522989466644374,0.7378364821936131
Missouri,29019,Boone County,38596,49999,91200,-11403,0.4232017543859649,0.5482346491228071,-0.12503289473684215
Missouri,29021,Buchanan County,22450,13445,36713,9005,0.611500013619154,0.36621905047258463,0.24528096314656933
Missouri,29023,Butler County,14599,3301,18165,11298,0.8036884117808973,0.1817230938618222,0.6219653179190752
Missouri,29025,Caldwell County,3725,897,4696,2828,0.7932282793867121,0.1910136286201022,0.60221465076661
Missouri,29027,Callaway County,14812,5868,21178,8944,0.6994050429691189,0.2770799886674851,0.42232505430163375
Missouri,29029,Camden County,18825,5640,24774,13185,0.7598692177282635,0.22765802857834827,0.5322111891499153
Missouri,29031,Cape Girardeau County,28873,10738,40252,18135,0.7173059723740435,0.26676935307562355,0.4505366192984199
Missouri,29033,Carroll County,3706,785,4531,2921,0.8179209887442066,0.17325093798278526,0.6446700507614214
Missouri,29035,Carter County,2451,418,2906,2033,0.8434273916035788,0.14384033035099794,0.6995870612525809
Missouri,29037,Cass County,37172,19035,57524,18137,0.6461998470203741,0.3309053612405257,0.3152944857798484
Missouri,29039,Cedar County,5786,1143,7039,4643,0.8219917601932093,0.16238102003125443,0.6596107401619549
Missouri,29041,Chariton County,3109,916,4074,2193,0.7631320569464899,0.22484045164457536,0.5382916053019146
Missouri,29043,Christian County,34904,11126,46904,23778,0.7441582807436466,0.23720791403718233,0.5069503667064643
Missouri,29045,Clark County,2672,678,3394,1994,0.7872716558632882,0.19976428992339423,0.5875073659398939
Missouri,29047,Clay County,64583,59519,126618,5064,0.5100617605711668,0.4700674469664661,0.03999431360470074
Missouri,29049,Clinton County,7789,2894,10894,4895,0.7149807233339452,0.26565081696346615,0.4493299063704791
Missouri,29051,Cole County,26066,12687,39486,13379,0.6601327052626247,0.3213037532289926,0.3388289520336321
Missouri,29053,Cooper County,6272,2249,8710,4023,0.7200918484500574,0.2582089552238806,0.46188289322617676
Missouri,29055,Crawford County,8725,2113,10973,6612,0.7951335095233756,0.19256356511437164,0.6025699444090039
Missouri,29057,Dade County,3414,656,4123,2758,0.8280378365268009,0.15910744603444094,0.6689303904923599
Missouri,29059,Dallas County,6620,1380,8122,5240,0.8150701797586801,0.16990888943609947,0.6451612903225806
Missouri,29061,Daviess County,3077,740,3884,2337,0.7922245108135942,0.19052523171987643,0.6016992790937178
Missouri,29063,DeKalb County,3827,930,4842,2897,0.7903758777364726,0.19206939281288724,0.5983064849235853
Missouri,29065,Dent County,5987,1056,7142,4931,0.8382805936712405,0.1478577429291515,0.6904228507420891
Missouri,29067,Douglas County,5896,1012,6994,4884,0.8430082928224192,0.14469545324563912,0.69831283957678
Missouri,29069,Dunklin County,8135,2200,10419,5935,0.7807851041366733,0.21115270179479798,0.5696324023418754
Missouri,29071,Franklin County,38034,14561,53750,23473,0.7076093023255814,0.2709023255813954,0.436706976744186
Missouri,29073,Gasconade County,6222,1601,7934,4621,0.7842198134610537,0.20178976556591882,0.582430047895135
Missouri,29075,Gentry County,2580,613,3239,1967,0.7965421426366163,0.18925594319234332,0.607286199444273
Missouri,29077,Greene County,81312,53307,138074,28005,0.5889016034879847,0.3860755826585744,0.20282602082941031
Missouri,29079,Grundy County,3585,799,4437,2786,0.8079783637592968,0.18007662835249041,0.6279017354068064
Missouri,29081,Harrison County,3198,597,3825,2601,0.836078431372549,0.156078431372549,0.6799999999999999
Missouri,29083,Henry County,8019,2615,10776,5404,0.7441536748329621,0.24266889383815887,0.5014847809948033
Missouri,29085,Hickory County,3965,1054,5080,2911,0.780511811023622,0.2074803149606299,0.5730314960629921
Missouri,29087,Holt County,1976,338,2343,1638,0.8433632095603927,0.14425949637217242,0.6991037131882203
Missouri,29089,Howard County,3552,1412,5089,2140,0.6979760267243074,0.27746119080369425,0.4205148359206131
Missouri,29091,Howell County,15174,3214,18637,11960,0.814186832644739,0.1724526479583624,0.6417341846863767
Missouri,29093,Iron County,3596,945,4592,2651,0.7831010452961672,0.20579268292682926,0.5773083623693379
Missouri,29095,Jackson County,125897,198031,330771,-72134,0.3806168013519928,0.5986951697700221,-0.21807836841802936
Missouri,29097,Jasper County,37714,13539,52515,24175,0.7181567171284395,0.25781205369894317,0.46034466342949637
Missouri,29099,Jefferson County,77021,37507,116629,39514,0.6603932126658035,0.32159239983194576,0.33880081283385777
Missouri,29101,Johnson County,15468,6961,23134,8507,0.6686262643727846,0.3008991095357483,0.36772715483703633
Missouri,29103,Knox County,1486,340,1856,1146,0.8006465517241379,0.18318965517241378,0.6174568965517241
Missouri,29105,Laclede County,13755,2779,16819,10976,0.8178250787799513,0.16522979963136927,0.652595279148582
Missouri,29107,Lafayette County,12262,4470,17083,7792,0.7177896154071299,0.2616636422174091,0.4561259731897208
Missouri,29109,Lawrence County,14421,3214,17930,11207,0.8042944785276074,0.1792526491912995,0.6250418293363079
Missouri,29111,Lewis County,3541,984,4607,2557,0.7686129802474495,0.2135880182331235,0.5550249620143259
Missouri,29113,Lincoln County,21702,6553,28814,15149,0.7531755396682168,0.22742416880683,0.5257513708613868
Missouri,29115,Linn County,4344,1274,5700,3070,0.7621052631578947,0.22350877192982457,0.5385964912280702
Missouri,29117,Livingston County,5266,1409,6755,3857,0.7795706883789786,0.2085862324204293,0.5709844559585493
Missouri,29119,McDonald County,7465,1437,9051,6028,0.8247707435642471,0.15876698707325157,0.6660037564909955
Missouri,29121,Macon County,6075,1661,7834,4414,0.7754659177942302,0.21202450855246363,0.5634414092417666
Missouri,29123,Madison County,4581,1017,5671,3564,0.8077940398518779,0.17933345089049552,0.6284605889613823
Missouri,29125,Maries County,3890,814,4774,3076,0.8148303309593632,0.17050691244239632,0.6443234185169668
Missouri,29127,Marion County,9910,3201,13370,6709,0.7412116679132386,0.2394166043380703,0.5017950635751682
Missouri,29129,Mercer County,1541,222,1779,1319,0.8662169758291175,0.12478920741989882,0.7414277684092186
Missouri,29131,Miller County,10175,2038,12379,8137,0.8219565393004281,0.16463365376847888,0.6573228855319493
Missouri,29133,Mississippi County,3537,1178,4756,2359,0.7436921783010934,0.24768713204373424,0.4960050462573591
Missouri,29135,Moniteau County,5738,1307,7150,4431,0.8025174825174826,0.1827972027972028,0.6197202797202798
Missouri,29137,Monroe County,3466,931,4469,2535,0.7755650033564556,0.20832400984560304,0.5672409935108526
Missouri,29139,Montgomery County,4457,1206,5770,3251,0.7724436741767764,0.20901213171577124,0.5634315424610051
Missouri,29141,Morgan County,7439,1924,9484,5515,0.7843736819907212,0.20286798819063687,0.5815056938000843
Missouri,29143,New Madrid County,5447,1748,7248,3699,0.7515176600441501,0.24116997792494482,0.5103476821192052
Missouri,29145,Newton County,22090,5793,28396,16297,0.7779264685166924,0.20400760670516974,0.5739188618115227
Missouri,29147,Nodaway County,6855,2849,9874,4006,0.6942475187360745,0.28853554790358515,0.40571197083248933
Missouri,29149,Oregon County,3847,823,4742,3024,0.8112610712779418,0.17355546183045129,0.6377056094474904
Missouri,29151,Osage County,6341,1031,7449,5310,0.8512552020405424,0.1384078399785206,0.7128473620620218
Missouri,29153,Ozark County,4064,752,4870,3312,0.8344969199178645,0.15441478439425052,0.680082135523614
Missouri,29155,Pemiscot County,4116,1556,5727,2560,0.7187008905185961,0.2716954775624236,0.44700541295617247
Missouri,29157,Perry County,7634,1661,9429,5973,0.8096298653091526,0.17615865945487327,0.6334712058542793
Missouri,29159,Pettis County,13835,4776,19069,9059,0.7255231003198909,0.2504588599297289,0.475064240390162
Missouri,29161,Phelps County,13438,5619,19531,7819,0.6880344068404075,0.2876964825149762,0.4003379243254313
Missouri,29163,Pike County,5856,1717,7686,4139,0.7619047619047619,0.22339318240957584,0.538511579495186
Missouri,29165,Platte County,29251,28111,58523,1140,0.4998205833603882,0.4803410624882525,0.019479520872135725
Missouri,29167,Polk County,11849,2883,15059,8966,0.7868384354870841,0.19144697523075901,0.5953914602563251
Missouri,29169,Pulaski County,10326,3735,14419,6591,0.7161384284624454,0.2590332200568694,0.45710520840557595
Missouri,29171,Putnam County,1984,361,2361,1623,0.8403218975010589,0.15290131300296483,0.6874205844980941
Missouri,29173,Ralls County,4396,1205,5662,3191,0.7764040974920523,0.21282232426704345,0.5635817732250088
Missouri,29175,Randolph County,8018,2485,10742,5533,0.7464159374418171,0.23133494693725562,0.5150809905045615
Missouri,29177,Ray County,8328,3107,11654,5221,0.7146044276643213,0.26660374120473657,0.44800068645958474
Missouri,29179,Reynolds County,2733,529,3298,2204,0.8286840509399637,0.16040024257125532,0.6682838083687084
Missouri,29181,Ripley County,4838,833,5743,4005,0.8424168553021069,0.14504614313076789,0.697370712171339
Missouri,29183,St. Charles County,128193,89346,222175,38847,0.5769911106110048,0.40214245527174525,0.17484865533925958
Missouri,29185,St. Clair County,3930,988,4972,2942,0.7904263877715205,0.19871279163314562,0.5917135961383749
Missouri,29186,Ste. Genevieve County,6627,2713,9495,3914,0.6979462875197472,0.28572933122696154,0.41221695629278565
Missouri,29187,St. Francois County,20506,7044,27996,13462,0.7324617802543221,0.2516073724817831,0.48085440777253896
Missouri,29189,St. Louis County,196808,322802,528107,-125994,0.3726669027299392,0.6112435548099154,-0.23857665207997625
Missouri,29195,Saline County,6447,2903,9528,3544,0.6766372795969773,0.30468094038623006,0.3719563392107472
Missouri,29197,Schuyler County,1606,373,2005,1233,0.800997506234414,0.1860349127182045,0.6149625935162095
Missouri,29199,Scotland County,1560,387,1985,1173,0.7858942065491183,0.19496221662468513,0.5909319899244332
Missouri,29201,Scott County,13769,3753,17748,10016,0.775805724588686,0.2114604462474645,0.5643452783412215
Missouri,29203,Shannon County,3164,706,3908,2458,0.8096212896622313,0.18065506653019447,0.6289662231320369
Missouri,29205,Shelby County,2700,592,3356,2108,0.8045292014302742,0.1764004767580453,0.6281287246722289
Missouri,29207,Stoddard County,11460,1814,13410,9646,0.854586129753915,0.13527218493661447,0.7193139448173005
Missouri,29209,Stone County,14716,3486,18378,11230,0.8007400152356078,0.18968331700946783,0.61105669822614
Missouri,29211,Sullivan County,1974,478,2471,1496,0.7988668555240793,0.19344394981788748,0.6054229057061918
Missouri,29213,Taney County,20426,5325,26240,15101,0.7784298780487805,0.2029344512195122,0.5754954268292682
Missouri,29215,Texas County,9478,1716,11332,7762,0.8363925167666785,0.15142957995058243,0.6849629368160961
Missouri,29217,Vernon County,7135,1902,9164,5233,0.7785901353120908,0.2075512876473156,0.5710388476647752
Missouri,29219,Warren County,13222,4769,18373,8453,0.7196429543351658,0.2595656670113754,0.4600772873237904
Missouri,29221,Washington County,8046,1804,9972,6242,0.8068592057761733,0.18090653830726033,0.625952667468913
Missouri,29223,Wayne County,4984,844,5874,4140,0.8484848484848485,0.14368403132448077,0.7048008171603677
Missouri,29225,Webster County,14874,3572,18776,11302,0.7921815083084789,0.1902428632296549,0.601938645078824
Missouri,29227,Worth County,877,215,1107,662,0.7922312556458898,0.1942186088527552,0.5980126467931346
Missouri,29229,Wright County,7452,1167,8741,6285,0.8525340350074362,0.13350875185905503,0.7190252831483812
Missouri,29510,St. Louis city,21185,108385,131876,-87200,0.160643331614547,0.8218705450574783,-0.6612272134429312
Montana,30001,Beaverhead County,3923,1608,5661,2315,0.6929871047518106,0.2840487546369899,0.40893835011482066
Montana,30003,Big Horn County,2185,2401,4669,-216,0.46798029556650245,0.5142428785607196,-0.04626258299421715
Montana,30005,Blaine County,1469,1589,3121,-120,0.4706824735661647,0.5091316885613585,-0.03844921499519377
Montana,30007,Broadwater County,3139,830,4056,2309,0.7739151873767258,0.20463510848126232,0.5692800788954635
Montana,30009,Carbon County,4424,2412,7045,2012,0.6279630943931866,0.3423704755145493,0.28559261887863735
Montana,30011,Carter County,775,74,864,701,0.8969907407407407,0.08564814814814815,0.8113425925925926
Montana,30013,Cascade County,23199,15384,39688,7815,0.5845343680709535,0.38762346301148964,0.19691090505946385
Montana,30015,Chouteau County,1888,988,2967,900,0.6363329962925514,0.33299629255139873,0.3033367037411526
Montana,30017,Custer County,4204,1510,5878,2694,0.715209254848588,0.25689009867301804,0.45831915617556995
Montana,30019,Daniels County,799,195,1014,604,0.7879684418145957,0.19230769230769232,0.5956607495069034
Montana,30021,Dawson County,3758,962,4837,2796,0.77692784783957,0.19888360554062434,0.5780442422989457
Montana,30023,Deer Lodge County,2184,2562,4888,-378,0.44680851063829785,0.5241407528641571,-0.07733224222585922
Montana,30025,Fallon County,1375,172,1575,1203,0.873015873015873,0.10920634920634921,0.7638095238095238
Montana,30027,Fergus County,4830,1491,6487,3339,0.7445660551872977,0.22984430399260058,0.5147217511946971
Montana,30029,Flathead County,38233,20238,60132,17995,0.635817867358478,0.33655956894831374,0.29925829841016427
Montana,30031,Gallatin County,31639,36964,71363,-5325,0.44335299805221196,0.5179714978350125,-0.07461849978280055
Montana,30033,Garfield County,764,41,813,723,0.939729397293973,0.05043050430504305,0.88929889298893
Montana,30035,Glacier County,1882,3603,5630,-1721,0.33428063943161634,0.6399644760213143,-0.305683836589698
Montana,30037,Golden Valley County,414,78,503,336,0.8230616302186878,0.1550695825049702,0.6679920477137177
Montana,30039,Granite County,1419,638,2102,781,0.6750713606089439,0.30352045670789723,0.37155090390104667
Montana,30041,Hill County,3952,2972,7167,980,0.551416213199386,0.414678387051765,0.13673782614762103
Montana,30043,Jefferson County,5345,2625,8191,2720,0.6525454767427664,0.32047369063606396,0.33207178610670246
Montana,30045,Judith Basin County,1040,275,1344,765,0.7738095238095238,0.20461309523809523,0.5691964285714286
Montana,30047,Lake County,9319,6911,16617,2408,0.5608112174279353,0.4158993801528555,0.14491183727507978
Montana,30049,Lewis and Clark County,21407,19741,42481,1666,0.5039193992608461,0.4647018667168852,0.039217532543960876
Montana,30051,Liberty County,821,249,1083,572,0.7580794090489381,0.2299168975069252,0.5281625115420129
Montana,30053,Lincoln County,8516,2812,11564,5704,0.736423382912487,0.24316845382220684,0.4932549290902801
Montana,30055,McCone County,956,155,1128,801,0.8475177304964538,0.1374113475177305,0.7101063829787233
Montana,30057,Madison County,4186,1770,6107,2416,0.6854429343376454,0.289831341084002,0.39561159325364337
Montana,30059,Meagher County,833,258,1110,575,0.7504504504504504,0.23243243243243245,0.5180180180180181
Montana,30061,Mineral County,1828,686,2562,1142,0.7135050741608119,0.2677595628415301,0.4457455113192818
Montana,30063,Missoula County,26336,43351,71969,-17015,0.3659353332684906,0.6023565701899429,-0.23642123692145234
Montana,30065,Musselshell County,2423,413,2881,2010,0.8410274210343631,0.1433530024297119,0.6976744186046512
Montana,30067,Park County,6022,5277,11612,745,0.518601446779194,0.45444367895280746,0.06415776782638649
Montana,30069,Petroleum County,298,39,351,259,0.8490028490028491,0.1111111111111111,0.737891737891738
Montana,30071,Phillips County,1936,414,2384,1522,0.8120805369127517,0.17365771812080538,0.6384228187919463
Montana,30073,Pondera County,2030,903,2994,1127,0.6780227120908484,0.3016032064128257,0.37641950567802274
Montana,30075,Powder River County,970,154,1136,816,0.8538732394366197,0.13556338028169015,0.7183098591549296
Montana,30077,Powell County,2347,752,3187,1595,0.7364292438029495,0.23595858173831188,0.5004706620646376
Montana,30079,Prairie County,603,126,744,477,0.8104838709677419,0.1693548387096774,0.6411290322580645
Montana,30081,Ravalli County,19103,8757,28490,10346,0.6705159705159706,0.30737100737100737,0.3631449631449632
Montana,30083,Richland County,4792,874,5789,3918,0.8277768181032994,0.15097598894455,0.6768008291587494
Montana,30085,Roosevelt County,1991,1902,4015,89,0.4958904109589041,0.4737235367372354,0.022166874221668742
Montana,30087,Rosebud County,2485,1199,3782,1286,0.6570597567424643,0.3170280274986779,0.3400317292437864
Montana,30089,Sanders County,5660,1819,7651,3841,0.739772578747876,0.23774669977780682,0.5020258789700692
Montana,30091,Sheridan County,1402,574,2029,828,0.6909807787087235,0.2828979793001479,0.40808279940857567
Montana,30093,Silver Bow County,7790,10442,18973,-2652,0.41058346070732094,0.5503610393717387,-0.1397775786644178
Montana,30095,Stillwater County,4430,1155,5707,3275,0.7762397056246715,0.20238303837392677,0.5738566672507447
Montana,30097,Sweet Grass County,1840,549,2446,1291,0.7522485690923958,0.22444807849550286,0.5278004905968929
Montana,30099,Teton County,2608,1007,3695,1601,0.7058186738836265,0.27253044654939107,0.43328822733423544
Montana,30101,Toole County,1596,467,2123,1129,0.7517663683466792,0.21997173810645312,0.5317946302402261
Montana,30103,Treasure County,373,78,460,295,0.8108695652173913,0.16956521739130434,0.6413043478260869
Montana,30105,Valley County,3135,1030,4272,2105,0.7338483146067416,0.24110486891385768,0.4927434456928839
Montana,30107,Wheatland County,823,225,1068,598,0.7705992509363296,0.21067415730337077,0.5599250936329588
Montana,30109,Wibaux County,516,77,598,439,0.862876254180602,0.12876254180602006,0.7341137123745819
Montana,30111,Yellowstone County,49548,29936,82217,19612,0.6026490871717528,0.36410961236727196,0.23853947480448084
Nebraska,31001,Adams County,10085,4213,14650,5872,0.68839590443686,0.28757679180887374,0.4008191126279863
Nebraska,31003,Antelope County,3093,452,3583,2641,0.8632430923806865,0.12615126988557074,0.7370918224951157
Nebraska,31005,Arthur County,260,21,284,239,0.9154929577464789,0.07394366197183098,0.8415492957746479
Nebraska,31007,Banner County,362,43,410,319,0.8829268292682927,0.1048780487804878,0.7780487804878049
Nebraska,31009,Blaine County,280,35,317,245,0.8832807570977917,0.11041009463722397,0.7728706624605678
Nebraska,31011,Boone County,2653,499,3217,2154,0.8246813801678583,0.15511345974510413,0.6695679204227541
Nebraska,31013,Box Butte County,4002,1051,5181,2951,0.7724377533294731,0.20285659139162324,0.5695811619378498
Nebraska,31015,Boyd County,1010,135,1153,875,0.8759757155247181,0.1170858629661752,0.7588898525585429
Nebraska,31017,Brown County,1468,190,1676,1278,0.8758949880668258,0.11336515513126491,0.7625298329355609
Nebraska,31019,Buffalo County,16473,6292,23474,10181,0.7017551333390134,0.26804123711340205,0.43371389622561135
Nebraska,31021,Burt County,2560,1061,3709,1499,0.6902129954165543,0.2860609328660016,0.40415206255055275
Nebraska,31023,Butler County,3526,869,4478,2657,0.7874050915587316,0.19405984814649396,0.5933452434122377
Nebraska,31025,Cass County,10121,4737,15318,5384,0.660725943334639,0.30924402663533096,0.351481916699308
Nebraska,31027,Cedar County,4174,725,4996,3449,0.8354683746997598,0.14511609287429944,0.6903522818254604
Nebraska,31029,Chase County,1740,226,1993,1514,0.8730556949322629,0.11339688911189162,0.7596588058203713
Nebraska,31031,Cherry County,2844,373,3265,2471,0.8710566615620214,0.11424196018376723,0.7568147013782542
Nebraska,31033,Cheyenne County,3813,855,4765,2958,0.8002098635886674,0.1794333683105981,0.6207764952780693
Nebraska,31035,Clay County,2848,632,3558,2216,0.8004496908375491,0.17762788083192804,0.6228218100056211
Nebraska,31037,Colfax County,2635,1024,3724,1611,0.7075725026852846,0.2749731471535983,0.4325993555316863
Nebraska,31039,Cuming County,3476,862,4412,2614,0.7878513145965549,0.19537624660018132,0.5924750679963735
Nebraska,31041,Custer County,4996,768,5877,4228,0.8500935851624979,0.13067891781521185,0.7194146673472861
Nebraska,31043,Dakota County,3926,2744,6794,1182,0.5778628201354136,0.4038857815719753,0.17397703856343827
Nebraska,31045,Dawes County,2919,1076,4102,1843,0.71160409556314,0.2623110677718186,0.44929302779132135
Nebraska,31047,Dawson County,6524,2497,9191,4027,0.7098248286367098,0.27167881623327167,0.43814601240343815
Nebraska,31049,Deuel County,901,153,1082,748,0.83271719038817,0.1414048059149723,0.6913123844731978
Nebraska,31051,Dixon County,2335,651,3083,1684,0.7573791761271489,0.21115796302302953,0.5462212131041193
Nebraska,31053,Dodge County,10963,5526,16880,5437,0.6494668246445497,0.3273696682464455,0.32209715639810427
Nebraska,31055,Douglas County,116696,146433,269960,-29737,0.4322714476218699,0.5424248036746184,-0.11015335605274851
Nebraska,31057,Dundy County,883,105,999,778,0.8838838838838838,0.10510510510510511,0.7787787787787788
Nebraska,31059,Fillmore County,2359,693,3134,1666,0.7527121888959796,0.22112316528398213,0.5315890236119974
Nebraska,31061,Franklin County,1434,276,1721,1158,0.8332364904125509,0.16037187681580475,0.6728646135967461
Nebraska,31063,Frontier County,1229,189,1440,1040,0.8534722222222222,0.13125,0.7222222222222222
Nebraska,31065,Furnas County,2163,399,2601,1764,0.831603229527105,0.15340253748558247,0.6782006920415224
Nebraska,31067,Gage County,7445,3385,11068,4060,0.672659920491507,0.30583664618720635,0.3668232743043007
Nebraska,31069,Garden County,1016,161,1195,855,0.8502092050209205,0.13472803347280335,0.7154811715481171
Nebraska,31071,Garfield County,925,133,1067,792,0.8669165885660731,0.1246485473289597,0.7422680412371134
Nebraska,31073,Gosper County,893,215,1118,678,0.7987477638640429,0.19230769230769232,0.6064400715563506
Nebraska,31075,Grant County,375,20,402,355,0.9328358208955224,0.04975124378109453,0.8830845771144279
Nebraska,31077,Greeley County,1016,229,1258,787,0.8076311605723371,0.1820349761526232,0.6255961844197139
Nebraska,31079,Hall County,15950,7551,23999,8399,0.6646110254593941,0.31463810992124674,0.34997291553814736
Nebraska,31081,Hamilton County,4297,1117,5520,3180,0.7784420289855073,0.2023550724637681,0.5760869565217392
Nebraska,31083,Harlan County,1615,282,1928,1333,0.8376556016597511,0.1462655601659751,0.6913900414937759
Nebraska,31085,Hayes County,492,34,532,458,0.924812030075188,0.06390977443609022,0.8609022556390977
Nebraska,31087,Hitchcock County,1260,174,1464,1086,0.860655737704918,0.11885245901639344,0.7418032786885246
Nebraska,31089,Holt County,4766,683,5531,4083,0.8616886638944133,0.12348580726812511,0.7382028566262883
Nebraska,31091,Hooker County,376,59,442,317,0.8506787330316742,0.1334841628959276,0.7171945701357466
Nebraska,31093,Howard County,2786,648,3501,2138,0.7957726363896029,0.18508997429305912,0.6106826620965438
Nebraska,31095,Jefferson County,2593,1009,3686,1584,0.7034725990233315,0.2737384698860553,0.42973412913727616
Nebraska,31097,Johnson County,1517,646,2227,871,0.6811854512797485,0.2900763358778626,0.3911091154018859
Nebraska,31099,Kearney County,2812,699,3591,2113,0.783068783068783,0.1946532999164578,0.5884154831523252
Nebraska,31101,Keith County,3544,763,4364,2781,0.8120989917506874,0.174839596700275,0.6372593950504124
Nebraska,31103,Keya Paha County,476,49,529,427,0.8998109640831758,0.09262759924385633,0.8071833648393195
Nebraska,31105,Kimball County,1553,267,1860,1286,0.8349462365591398,0.1435483870967742,0.6913978494623656
Nebraska,31107,Knox County,3719,903,4693,2816,0.7924568506285958,0.1924142339654805,0.6000426166631153
Nebraska,31109,Lancaster County,68321,80513,153031,-12192,0.44645202606007933,0.5261221582555169,-0.07967013219543756
Nebraska,31111,Lincoln County,13071,3692,17151,9379,0.7621129963267448,0.21526441606903388,0.5468485802577109
Nebraska,31113,Logan County,407,38,450,369,0.9044444444444445,0.08444444444444445,0.8200000000000001
Nebraska,31115,Loup County,370,75,454,295,0.8149779735682819,0.16519823788546256,0.6497797356828194
Nebraska,31117,McPherson County,275,17,302,258,0.9105960264900662,0.056291390728476824,0.8543046357615894
Nebraska,31119,Madison County,11678,3393,15407,8285,0.7579671577854222,0.22022457324592717,0.5377425845394951
Nebraska,31121,Merrick County,3407,740,4267,2667,0.7984532458401687,0.1734239512538083,0.6250292945863605
Nebraska,31123,Morrill County,2113,386,2558,1727,0.8260359655981235,0.15089913995308835,0.6751368256450352
Nebraska,31125,Nance County,1437,359,1828,1078,0.7861050328227571,0.1963894967177243,0.5897155361050328
Nebraska,31127,Nemaha County,2428,921,3423,1507,0.7093193105463044,0.26906222611744085,0.4402570844288635
Nebraska,31129,Nuckolls County,1850,409,2296,1441,0.8057491289198606,0.17813588850174217,0.6276132404181185
Nebraska,31131,Otoe County,5609,2481,8306,3128,0.6752949674933783,0.29869973513123044,0.3765952323621478
Nebraska,31133,Pawnee County,1071,322,1429,749,0.7494751574527642,0.22533240027991602,0.5241427571728481
Nebraska,31135,Perkins County,1321,199,1545,1122,0.8550161812297734,0.12880258899676375,0.7262135922330096
Nebraska,31137,Phelps County,4157,752,5009,3405,0.8299061688959872,0.1501297664204432,0.679776402475544
Nebraska,31139,Pierce County,3462,480,4006,2982,0.8642036944583126,0.11982026959560658,0.744383424862706
Nebraska,31141,Platte County,11827,3208,15256,8619,0.7752359727320398,0.21027792343995805,0.5649580492920818
Nebraska,31143,Polk County,2286,527,2870,1759,0.7965156794425087,0.18362369337979095,0.6128919860627178
Nebraska,31145,Red Willow County,4525,811,5452,3714,0.8299706529713866,0.1487527512839325,0.6812179016874541
Nebraska,31147,Richardson County,2981,981,4018,2000,0.7419113987058238,0.24415131906421106,0.49776007964161273
Nebraska,31149,Rock County,744,84,841,660,0.8846611177170036,0.09988109393579073,0.7847800237812129
Nebraska,31151,Saline County,3458,1737,5336,1721,0.6480509745127436,0.3255247376311844,0.32252623688155924
Nebraska,31153,Sarpy County,51518,41029,95409,10489,0.5399700237923047,0.4300328061294008,0.10993721766290393
Nebraska,31155,Saunders County,9036,3318,12646,5718,0.7145342400759134,0.2623754546892298,0.4521587853866836
Nebraska,31157,Scotts Bluff County,10810,4133,15289,6677,0.707044280201452,0.270325070311989,0.43671920988946306
Nebraska,31159,Seward County,6490,2438,9142,4052,0.7099103040910085,0.2666812513673157,0.44322905272369284
Nebraska,31161,Sheridan County,2292,340,2672,1952,0.8577844311377245,0.12724550898203593,0.7305389221556886
Nebraska,31163,Sherman County,1306,341,1680,965,0.7773809523809524,0.20297619047619048,0.5744047619047619
Nebraska,31165,Sioux County,642,72,729,570,0.8806584362139918,0.09876543209876543,0.7818930041152263
Nebraska,31167,Stanton County,2561,532,3165,2029,0.8091627172195892,0.16808846761453397,0.6410742496050552
Nebraska,31169,Thayer County,2285,619,2951,1666,0.7743137919349373,0.2097594035920027,0.5645543883429346
Nebraska,31171,Thomas County,377,45,427,332,0.882903981264637,0.1053864168618267,0.7775175644028103
Nebraska,31173,Thurston County,1164,1107,2294,57,0.5074106364428945,0.48256320836966,0.024847428073234534
Nebraska,31175,Valley County,1892,410,2333,1482,0.810972996142306,0.17573939134162023,0.6352336048006858
Nebraska,31177,Washington County,8583,3554,12413,5029,0.6914525094658825,0.2863127366470636,0.40513977281881897
Nebraska,31179,Wayne County,3055,1022,4200,2033,0.7273809523809524,0.24333333333333335,0.484047619047619
Nebraska,31181,Webster County,1511,335,1876,1176,0.8054371002132196,0.17857142857142858,0.626865671641791
Nebraska,31183,Wheeler County,438,59,502,379,0.8725099601593626,0.11752988047808766,0.7549800796812749
Nebraska,31185,York County,5296,1619,7089,3677,0.747072929891381,0.22838200028212724,0.5186909296092537
Nevada,32001,Churchill County,9088,2966,12503,6122,0.7268655522674559,0.23722306646404862,0.48964248580340725
Nevada,32003,Clark County,379570,457312,852228,-77742,0.44538550716474934,0.536607574498843,-0.09122206733409366
Nevada,32005,Douglas County,21237,11390,33537,9847,0.6332408981125325,0.3396248919104273,0.2936160062021052
Nevada,32007,Elko County,15726,4246,20575,11480,0.764325637910085,0.20636695018226003,0.557958687727825
Nevada,32009,Esmeralda County,389,72,474,317,0.820675105485232,0.1518987341772152,0.6687763713080168
Nevada,32011,Eureka County,833,92,942,741,0.8842887473460722,0.09766454352441614,0.7866242038216561
Nevada,32013,Humboldt County,5531,1608,7324,3923,0.755188421627526,0.21955215729109775,0.5356362643364282
Nevada,32015,Lander County,2110,478,2653,1632,0.7953260459856766,0.18017338861666038,0.6151526573690163
Nevada,32017,Lincoln County,1949,318,2312,1631,0.8429930795847751,0.1375432525951557,0.7054498269896194
Nevada,32019,Lyon County,20302,8264,29392,12038,0.6907321720195971,0.28116494284158955,0.4095672291780076
Nevada,32021,Mineral County,1343,759,2179,584,0.6163377696190914,0.3483249196879302,0.26801284993116115
Nevada,32023,Nye County,15791,6618,22857,9173,0.6908605678785492,0.28953930962068514,0.4013212582578641
Nevada,32027,Pershing County,1668,525,2232,1143,0.7473118279569892,0.23521505376344087,0.5120967741935484
Nevada,32029,Storey County,1905,899,2870,1006,0.6637630662020906,0.3132404181184669,0.35052264808362366
Nevada,32031,Washoe County,113450,123690,244132,-10240,0.46470761719070014,0.5066521390067669,-0.04194452181606673
Nevada,32033,White Pine County,3238,836,4177,2402,0.7751975101747666,0.2001436437634666,0.5750538664113
Nevada,32510,Carson City,15771,12485,29126,3286,0.5414749708164527,0.42865481013527434,0.11282016068117834
New Hampshire,33001,Belknap County,20870,16857,38387,4013,0.5436736395133769,0.43913303983119284,0.10454059968218404
New Hampshire,33003,Carroll County,16065,16618,33111,-553,0.4851861918999728,0.5018875902268128,-0.016701398326840033
New Hampshire,33005,Cheshire County,17892,25502,44200,-7610,0.40479638009049773,0.5769683257918552,-0.17217194570135747
New Hampshire,33007,Coos County,8611,7625,16507,986,0.5216574786454231,0.4619252438359484,0.059732234809474705
New Hampshire,33009,Grafton County,19905,33180,53989,-13275,0.3686862138583786,0.6145696345551872,-0.24588342069680863
New Hampshire,33011,Hillsborough County,104553,120032,230531,-15479,0.4535311953706877,0.5206761780411311,-0.06714498267044339
New Hampshire,33013,Merrimack County,39518,48323,89477,-8805,0.44165539747644644,0.5400605742257787,-0.09840517674933225
New Hampshire,33015,Rockingham County,95858,100064,198952,-4206,0.4818147090755559,0.502955486750573,-0.021140777675017097
New Hampshire,33017,Strafford County,30486,41693,73676,-11207,0.41378467886421627,0.5658966284814594,-0.15211194961724311
New Hampshire,33019,Sullivan County,11490,12390,24365,-900,0.4715780833162323,0.5085163143853889,-0.03693823106915661
New Jersey,34001,Atlantic County,60912,68933,131890,-8021,0.46183941163090453,0.5226552430055349,-0.06081583137463037
New Jersey,34003,Bergen County,182831,259358,448647,-76527,0.4075163770180119,0.578089232737542,-0.17057285571953007
New Jersey,34005,Burlington County,79881,131202,214299,-51321,0.3727548891968698,0.612238041241443,-0.2394831520445732
New Jersey,34007,Camden County,62174,140026,205125,-77852,0.303102985984156,0.6826374162096283,-0.37953443022547223
New Jersey,34009,Cape May County,31498,22713,54980,8785,0.5728992360858494,0.4131138595853037,0.15978537650054564
New Jersey,34011,Cumberland County,17387,22257,40103,-4870,0.43355858663940355,0.5549958855945939,-0.12143729895519034
New Jersey,34013,Essex County,63971,224615,291105,-160644,0.2197523230449494,0.7715944418680545,-0.5518421188231051
New Jersey,34015,Gloucester County,80700,84120,168093,-3420,0.48009137798718565,0.5004372579464939,-0.0203458799593082
New Jersey,34017,Hudson County,45160,141997,189521,-96837,0.23828493939985543,0.7492415088565383,-0.5109565694566829
New Jersey,34019,Hunterdon County,39751,37419,78998,2332,0.503189954176055,0.47367021949922783,0.029519734676827225
New Jersey,34021,Mercer County,45926,109514,158252,-63588,0.2902080226474231,0.6920228496322322,-0.401814826984809
New Jersey,34023,Middlesex County,70250,141256,213777,-71006,0.32861346169138866,0.6607633187854633,-0.3321498570940747
New Jersey,34025,Monmouth County,142212,146893,292654,-4681,0.48593902697383257,0.5019340244794194,-0.015994997505586805
New Jersey,34027,Morris County,63209,83266,148759,-20057,0.42490874501710824,0.5597375620970833,-0.13482881707997502
New Jersey,34029,Ocean County,202449,112552,320036,89897,0.6325819595295529,0.3516854353885188,0.28089652414103405
New Jersey,34031,Passaic County,53826,84346,139854,-30520,0.3848727959157407,0.6031003761065111,-0.21822758019077043
New Jersey,34033,Salem County,16524,12786,29905,3738,0.5525497408460124,0.42755392074903864,0.12499582009697374
New Jersey,34035,Somerset County,61074,97301,160774,-36227,0.37987485538706506,0.6052035776929106,-0.2253287223058455
New Jersey,34037,Sussex County,38188,28728,68327,9460,0.5589005810294613,0.42044872451593074,0.13845185651353054
New Jersey,34039,Union County,32427,88990,122777,-56563,0.2641129853311288,0.7248100214209502,-0.4606970360898214
New Jersey,34041,Warren County,23806,19327,43985,4479,0.5412299647607138,0.4393997953847903,0.10183016937592354
New Mexico,35001,Bernalillo County,115674,192042,315332,-76368,0.36683241789605875,0.6090152601068081,-0.24218284221074932
New Mexico,35003,Catron County,1698,594,2325,1104,0.7303225806451613,0.25548387096774194,0.47483870967741937
New Mexico,35005,Chaves County,15656,6381,22443,9275,0.6975894488259146,0.2843202780376955,0.41326917078821906
New Mexico,35006,Cibola County,3962,4696,8839,-734,0.44824075121620094,0.5312818192103179,-0.08304106799411698
New Mexico,35007,Colfax County,3271,2611,6016,660,0.543716755319149,0.4340093085106383,0.10970744680851069
New Mexico,35009,Curry County,10428,4300,15077,6128,0.6916495324003449,0.2852026265172116,0.40644690588313326
New Mexico,35011,De Baca County,654,231,899,423,0.7274749721913237,0.25695216907675195,0.4705228031145718
New Mexico,35013,DoÃ±a Ana County,32760,47919,82556,-15159,0.3968215514317554,0.5804423663937206,-0.1836208149619652
New Mexico,35015,Eddy County,17454,5424,23222,12030,0.7516148479889759,0.23357161312548447,0.5180432348634915
New Mexico,35017,Grant County,6553,7590,14435,-1037,0.45396605472809143,0.5258053342570143,-0.07183927952892283
New Mexico,35019,Guadalupe County,912,1229,2179,-317,0.41854061496099126,0.5640201927489674,-0.14547957778797616
New Mexico,35021,Harding County,319,179,505,140,0.6316831683168317,0.35445544554455444,0.27722772277227725
New Mexico,35023,Hidalgo County,1105,812,1948,293,0.5672484599589322,0.41683778234086244,0.1504106776180698
New Mexico,35025,Lea County,16531,4061,20918,12470,0.7902763170475189,0.1941390190266756,0.5961372980208433
New Mexico,35027,Lincoln County,6942,3194,10306,3748,0.6735882010479333,0.30991655346400154,0.3636716475839317
New Mexico,35028,Los Alamos County,4274,7549,12284,-3275,0.34793226961901663,0.614539238033214,-0.26660696841419734
New Mexico,35029,Luna County,4407,3564,8103,843,0.5438726397630507,0.43983709737134397,0.1040355423917067
New Mexico,35031,McKinley County,7717,17826,26193,-10109,0.29462070018707287,0.680563509334555,-0.38594280914748214
New Mexico,35033,Mora County,902,1744,2683,-842,0.3361908311591502,0.6500186358553858,-0.31382780469623556
New Mexico,35035,Otero County,14521,8483,23569,6038,0.6161059018201875,0.35992193135050277,0.2561839704696848
New Mexico,35037,Quay County,2634,1170,3873,1464,0.6800929512006196,0.3020914020139427,0.37800154918667694
New Mexico,35039,Rio Arriba County,5390,10896,16511,-5506,0.3264490339773484,0.6599236872388105,-0.33347465326146203
New Mexico,35041,Roosevelt County,4634,1802,6608,2832,0.701271186440678,0.2726997578692494,0.4285714285714286
New Mexico,35043,Sandoval County,34063,40361,76215,-6298,0.44693301843469135,0.529567670406088,-0.08263465197139663
New Mexico,35045,San Juan County,32872,18076,52284,14796,0.6287200673246117,0.34572718231198835,0.2829928850126234
New Mexico,35047,San Miguel County,3414,7869,11504,-4455,0.2967663421418637,0.6840229485396384,-0.3872566063977747
New Mexico,35049,Santa Fe County,18236,61629,81213,-43393,0.2245453314124586,0.7588563407336264,-0.5343110093211678
New Mexico,35051,Sierra County,3542,2265,5945,1277,0.5957947855340623,0.3809924306139613,0.21480235492010097
New Mexico,35053,Socorro County,3255,3721,7159,-466,0.454672440284956,0.5197653303534013,-0.06509289006844532
New Mexico,35055,Taos County,3638,12816,16790,-9178,0.21667659321024418,0.7633114949374628,-0.5466349017272185
New Mexico,35057,Torrance County,4772,2344,7281,2428,0.6554044774069496,0.3219338003021563,0.33347067710479333
New Mexico,35059,Union County,1388,383,1789,1005,0.7758524315259921,0.21408608160983789,0.5617663499161543
New Mexico,35061,Valencia County,17245,14051,31939,3194,0.5399355020507843,0.43993237108237576,0.10000313096840857
New York,36001,Albany County,45570,73189,121529,-27619,0.374972228850727,0.6022348575237186,-0.22726262867299163
New York,36003,Allegany County,12670,4188,17271,8482,0.7335996757570494,0.2424874066354004,0.49111226912164907
New York,36005,Bronx County,55849,271835,329638,-215986,0.16942524830268355,0.824647037052767,-0.6552217887500834
New York,36007,Broome County,38296,32209,72251,6087,0.5300411066974852,0.44579313781124136,0.08424796888624381
New York,36009,Cattaraugus County,20295,9142,30051,11153,0.6753519017669961,0.304216165851386,0.3711357359156101
New York,36011,Cayuga County,17639,11993,30296,5646,0.5822220755215209,0.39586083971481384,0.1863612358067071
New York,36013,Chautauqua County,31247,16200,48428,15047,0.6452259023705295,0.3345172214421409,0.31070868092838855
New York,36015,Chemung County,19388,11573,31646,7815,0.6126524679264362,0.3657018264551602,0.24695064147127604
New York,36017,Chenango County,11736,5126,17241,6610,0.6807029754654602,0.2973145409199002,0.38338843454556
New York,36019,Clinton County,14354,12690,27471,1664,0.5225146518146409,0.461941683957628,0.06057296785701283
New York,36021,Columbia County,12883,14148,27537,-1265,0.46784326542470134,0.5137814576751281,-0.045938192250426724
New York,36023,Cortland County,9484,6829,16700,2655,0.5679041916167664,0.4089221556886228,0.15898203592814364
New York,36025,Delaware County,11952,6420,18763,5532,0.6369983478121836,0.34216276714811067,0.2948355806640729
New York,36027,Dutchess County,59661,57720,119539,1941,0.4990923464308719,0.4828549678347652,0.01623737859610669
New York,36029,Erie County,178349,198808,383952,-20459,0.46450858440638415,0.5177938909030295,-0.05328530649664537
New York,36031,Essex County,7953,6970,15185,983,0.5237405334211392,0.45900559762923937,0.06473493579189987
New York,36033,Franklin County,8530,6586,15397,1944,0.5540040267584594,0.4277456647398844,0.126258362018575
New York,36035,Fulton County,13989,5804,20153,8185,0.6941398302982186,0.28799682429414974,0.40614300600406883
New York,36037,Genesee County,17340,7048,25004,10292,0.6934890417533195,0.28187490001599746,0.411614141737322
New York,36039,Greene County,12722,7675,20882,5047,0.6092328321042045,0.3675414232353223,0.24169140886888224
New York,36041,Hamilton County,1917,863,2825,1054,0.6785840707964602,0.3054867256637168,0.3730973451327434
New York,36043,Herkimer County,17038,7282,24766,9756,0.6879592990390051,0.29403214083824597,0.39392715820075913
New York,36045,Jefferson County,22779,12053,35530,10726,0.641120180129468,0.33923444976076556,0.3018857303687025
New York,36047,Kings County,174731,514133,693937,-339402,0.2517966328355456,0.7408929052637343,-0.4890962724281887
New York,36049,Lewis County,7931,2768,10878,5163,0.7290862290862291,0.2544585401728259,0.47462768891340323
New York,36051,Livingston County,16575,9150,26333,7425,0.6294383473208521,0.34747275281965595,0.2819655945011962
New York,36053,Madison County,16553,10417,27698,6136,0.597624377211351,0.3760921366163622,0.22153224059498877
New York,36055,Monroe County,122995,146403,276241,-23408,0.4452452749591842,0.5299828772702098,-0.08473760231102556
New York,36057,Montgomery County,11500,5746,17615,5754,0.6528526823729776,0.32619926199261995,0.3266534203803576
New York,36059,Nassau County,286661,280288,572706,6373,0.5005377977531229,0.48940992411464174,0.011127873638481167
New York,36061,New York County,65001,377605,446861,-312604,0.14546134032730537,0.84501668304014,-0.6995553427128346
New York,36063,Niagara County,51355,34809,87821,16546,0.5847690187996037,0.39636305667209437,0.18840596212750937
New York,36065,Oneida County,51950,30542,84099,21408,0.6177243486842887,0.36316721958643977,0.25455712909784894
New York,36067,Onondaga County,78994,93850,176798,-14856,0.446803696874399,0.5308317967397821,-0.08402809986538307
New York,36069,Ontario County,25757,20779,47830,4978,0.5385113945222664,0.43443445536274305,0.10407693915952332
New York,36071,Orange County,76218,61868,139956,14350,0.5445854411386436,0.4420532167252565,0.10253222441338711
New York,36073,Orleans County,11173,4082,15625,7091,0.715072,0.261248,0.45382400000000006
New York,36075,Oswego County,28914,14677,44546,14237,0.6490818479773717,0.32947963902482824,0.31960220895254343
New York,36077,Otsego County,12682,9138,22340,3544,0.5676812891674127,0.4090420769919427,0.15863921217546995
New York,36079,Putnam County,25899,17106,43661,8793,0.5931838482856554,0.3917913011612194,0.201392547124436
New York,36081,Queens County,173304,769135,946572,-595831,0.18308591422522533,0.8125478040761822,-0.6294618898509569
New York,36083,Rensselaer County,33371,30450,65285,2921,0.5111587654131883,0.46641648158076127,0.04474228383242701
New York,36085,Richmond County,110094,67223,178751,42871,0.6159070438766776,0.37607062338112796,0.23983642049554965
New York,36087,Rockland County,63830,50926,116024,12904,0.550144797628077,0.4389264290146866,0.1112183686133904
New York,36089,St. Lawrence County,21862,13036,35519,8826,0.6155015625439906,0.3670148371294237,0.2484867254145669
New York,36091,Saratoga County,55248,49697,107583,5551,0.5135383843172249,0.461941012985323,0.0515973713319019
New York,36093,Schenectady County,27544,31685,60591,-4141,0.45458896535789145,0.5229324487135053,-0.06834348335561385
New York,36095,Schoharie County,9010,4006,13374,5004,0.6736952295498729,0.29953641393749064,0.3741588156123823
New York,36097,Schuyler County,5181,2858,8220,2323,0.6302919708029197,0.3476885644768856,0.28260340632603403
New York,36099,Seneca County,7582,5076,12954,2506,0.5853018372703412,0.3918480778138027,0.19345375945653853
New York,36101,Steuben County,26781,11299,38797,15482,0.6902853313400521,0.29123385828801196,0.39905147305204014
New York,36103,Suffolk County,333100,258007,598129,75093,0.5569032767178986,0.4313567808950912,0.1255464958228074
New York,36105,Sullivan County,15555,10995,26931,4560,0.5775871672050796,0.4082655675615462,0.16932159964353344
New York,36107,Tioga County,13292,6724,20555,6568,0.6466553150085137,0.327122354658234,0.31953296035027967
New York,36109,Tompkins County,8522,21643,30851,-13121,0.27623091633982694,0.7015331755858806,-0.42530225924605364
New York,36111,Ulster County,33580,42606,77667,-9026,0.43235865940489526,0.5485727529066399,-0.11621409350174461
New York,36113,Warren County,15200,11811,27625,3389,0.5502262443438914,0.4275475113122172,0.12267873303167426
New York,36115,Washington County,14577,8537,23607,6040,0.6174863387978142,0.36163002499258695,0.2558563138052273
New York,36117,Wayne County,23734,12799,37425,10935,0.6341750167000668,0.3419906479625919,0.29218436873747494
New York,36119,Westchester County,217725,400881,625318,-183156,0.3481828445686835,0.6410834167575538,-0.2929005721888703
New York,36121,Wyoming County,12969,3840,17162,9129,0.7556811560424193,0.22375014567066775,0.5319310103717515
New York,36123,Yates County,5552,3046,8817,2506,0.6296926392196892,0.34546898037881363,0.2842236588408756
North Carolina,37001,Alamance County,45490,38186,84710,7304,0.5370086176366426,0.4507850312832015,0.08622358635344113
North Carolina,37003,Alexander County,15806,4113,20120,11693,0.7855864811133201,0.2044234592445328,0.5811630218687873
North Carolina,37005,Alleghany County,4501,1480,6040,3021,0.7451986754966887,0.24503311258278146,0.5001655629139072
North Carolina,37007,Anson County,5321,5788,11183,-467,0.4758114995976035,0.5175713136010015,-0.04175981400339801
North Carolina,37009,Ashe County,11368,4149,15691,7219,0.7244917468612581,0.2644190937480084,0.46007265311324963
North Carolina,37011,Avery County,7092,2171,9339,4921,0.7593960809508513,0.232466002784024,0.5269300781668274
North Carolina,37013,Beaufort County,16352,9575,26164,6777,0.6249808897722061,0.36596086225347807,0.25902002751872805
North Carolina,37015,Bertie County,3778,5846,9680,-2068,0.3902892561983471,0.6039256198347107,-0.21363636363636362
North Carolina,37017,Bladen County,9623,7281,17009,2342,0.5657593038979364,0.42806749367981656,0.13769181021811983
North Carolina,37019,Brunswick County,55373,32984,89328,22389,0.6198840229267419,0.3692459251298585,0.25063809779688345
North Carolina,37021,Buncombe County,61983,95881,160443,-33898,0.38632411510629944,0.5976016404579819,-0.21127752535168248
North Carolina,37023,Burke County,30814,12985,44182,17829,0.6974333438957041,0.2938979674980761,0.403535376397628
North Carolina,37025,Cabarrus County,62974,51943,116722,11031,0.5395212556330427,0.44501465019447917,0.09450660543856348
North Carolina,37027,Caldwell County,31877,10105,42438,21772,0.7511428436778359,0.23811206937178944,0.5130307743060465
North Carolina,37029,Camden County,4277,1515,5879,2762,0.7275046776662698,0.25769688722571865,0.46980779044055115
North Carolina,37031,Carteret County,29886,11999,42446,17887,0.7040946143335061,0.2826885925646704,0.4214060217688357
North Carolina,37033,Caswell County,7040,4831,11962,2209,0.5885303460959705,0.4038622303962548,0.18466811569971575
North Carolina,37035,Catawba County,56203,25420,82751,30783,0.679182124687315,0.3071866201012677,0.3719955045860473
North Carolina,37037,Chatham County,21055,26642,48308,-5587,0.43584913471888714,0.5515028566697028,-0.11565372195081564
North Carolina,37039,Cherokee County,12568,3563,16341,9005,0.7691083777002632,0.2180405115965975,0.5510678661036656
North Carolina,37041,Chowan County,4458,3232,7754,1226,0.5749290688676812,0.4168171266443126,0.15811194222336866
North Carolina,37043,Clay County,5074,1685,6828,3389,0.7431165787932045,0.24677797305213825,0.49633860574106625
North Carolina,37045,Cleveland County,33664,16879,51095,16785,0.658851159604658,0.33034543497406793,0.3285057246305901
North Carolina,37047,Columbus County,16696,9382,26243,7314,0.6362077506382654,0.3575048584384407,0.2787028921998247
North Carolina,37049,Craven County,30831,20977,52675,9854,0.5853061224489796,0.398234456573327,0.1870716658756526
North Carolina,37051,Cumberland County,59498,83533,145598,-24035,0.4086457231555379,0.5737235401585187,-0.1650778170029808
North Carolina,37053,Currituck County,11566,4151,16006,7415,0.7226040234911908,0.2593402474072223,0.4632637760839685
North Carolina,37055,Dare County,13844,9855,24061,3989,0.5753709322139562,0.4095839740659158,0.1657869581480404
North Carolina,37057,Davidson County,62143,21483,84785,40660,0.7329480450551394,0.25338208409506396,0.4795659609600755
North Carolina,37059,Davie County,18115,6653,25059,11462,0.7228939702302566,0.2654934354922383,0.4574005347380183
North Carolina,37061,Duplin County,13703,8676,22510,5027,0.608751665926255,0.38542869835628607,0.2233229675699689
North Carolina,37063,Durham County,31827,142770,177227,-110943,0.17958324634508285,0.8055770283308976,-0.6259937819858148
North Carolina,37065,Edgecombe County,9162,16027,25344,-6865,0.3615056818181818,0.6323784722222222,-0.2708727904040404
North Carolina,37067,Forsyth County,84176,111769,198469,-27593,0.4241266898104994,0.5631559588651124,-0.139029269054613
North Carolina,37069,Franklin County,20748,15776,37079,4972,0.5595620162356051,0.4254699425550851,0.13409207368052
North Carolina,37071,Gaston County,72132,40231,113791,31901,0.6338989902540623,0.35355168686451477,0.2803473033895475
North Carolina,37073,Gates County,3354,2540,5944,814,0.5642664872139973,0.42732166890982504,0.13694481830417227
North Carolina,37075,Graham County,3667,896,4606,2771,0.7961354754667824,0.1945288753799392,0.6016066000868432
North Carolina,37077,Granville County,16548,14448,31316,2100,0.5284199770085579,0.46136160429173584,0.06705837271682208
North Carolina,37079,Greene County,4858,3820,8715,1038,0.557429718875502,0.438324727481354,0.11910499139414799
North Carolina,37081,Guilford County,106384,171538,281201,-65154,0.3783201339966785,0.6100191677838983,-0.2316990337872198
North Carolina,37083,Halifax County,9973,15382,25485,-5409,0.391328232293506,0.6035707278791446,-0.21224249558563857
North Carolina,37085,Harnett County,34905,21839,57733,13066,0.604593560009007,0.3782758560961668,0.22631770391284017
North Carolina,37087,Haywood County,22698,13095,36265,9603,0.6258927340410865,0.3610919619467806,0.26480077209430586
North Carolina,37089,Henderson County,39810,27014,67773,12796,0.587402062768359,0.398595310816992,0.18880675195136704
North Carolina,37091,Hertford County,3470,7077,10590,-3607,0.3276676109537299,0.668271954674221,-0.34060434372049103
North Carolina,37093,Hoke County,9601,11929,21879,-2328,0.43882261529320354,0.5452260158142511,-0.10640340052104758
North Carolina,37095,Hyde County,1408,1035,2470,373,0.5700404858299595,0.4190283400809717,0.1510121457489878
North Carolina,37097,Iredell County,66439,33426,101276,33013,0.6560191950708953,0.33004858011769816,0.3259706149531972
North Carolina,37099,Jackson County,11263,9522,21237,1741,0.530347977586288,0.4483684136177426,0.08197956396854544
North Carolina,37101,Johnston County,67901,40861,110246,27040,0.6159044319068265,0.37063476225894815,0.24526966964787839
North Carolina,37103,Jones County,3267,2175,5484,1092,0.5957330415754923,0.3966083150984683,0.19912472647702406
North Carolina,37105,Lee County,16388,12076,28851,4312,0.5680219056531836,0.4185643478562268,0.14945755779695674
North Carolina,37107,Lenoir County,14500,13494,28177,1006,0.5146041097348901,0.4789012315008695,0.03570287823402063
North Carolina,37109,Lincoln County,36167,13178,49850,22989,0.7255165496489469,0.2643530591775326,0.46116349047141425
North Carolina,37111,McDowell County,16839,5807,22891,11032,0.7356166178847582,0.2536804857804377,0.48193613210432046
North Carolina,37113,Macon County,14152,6213,20647,7939,0.6854264542064222,0.30091538722332545,0.3845110669830968
North Carolina,37115,Madison County,7928,4878,13000,3050,0.6098461538461538,0.37523076923076926,0.23461538461538456
North Carolina,37117,Martin County,6493,5876,12454,617,0.5213585996466998,0.4718162839248434,0.04954231572185641
North Carolina,37119,Mecklenburg County,178066,375503,563218,-197437,0.316158219375091,0.6667098707782777,-0.3505516514031867
North Carolina,37121,Mitchell County,7041,1852,8960,5189,0.7858258928571429,0.20669642857142856,0.5791294642857143
North Carolina,37123,Montgomery County,8363,4305,12779,4058,0.6544330542295954,0.3368808200954691,0.3175522341341263
North Carolina,37125,Moore County,36459,20547,57771,15912,0.6310951861660695,0.35566287583735784,0.2754323103287117
North Carolina,37127,Nash County,25653,25702,51826,-49,0.4949832130590823,0.49592868444410143,-0.0009454713850191032
North Carolina,37129,New Hanover County,62420,64876,129254,-2456,0.4829250932272889,0.5019264394138673,-0.019001346186578394
North Carolina,37131,Northampton County,3977,6048,10075,-2071,0.3947394540942928,0.6002977667493796,-0.20555831265508684
North Carolina,37133,Onslow County,45016,23474,70117,21542,0.6420126360226479,0.33478329078540153,0.3072293452372464
North Carolina,37135,Orange County,19993,63097,84010,-43104,0.23798357338412093,0.751065349363171,-0.5130817759790501
North Carolina,37137,Pamlico County,4815,2699,7572,2116,0.6358954041204438,0.3564447966191231,0.27945060750132067
North Carolina,37139,Pasquotank County,9626,9653,19512,-27,0.4933374333743337,0.4947211972119721,-0.0013837638376383854
North Carolina,37141,Pender County,21833,11655,33971,10178,0.6426952400576963,0.34308675046363074,0.29960848959406555
North Carolina,37143,Perquimans County,4894,2485,7457,2409,0.6562960976263913,0.3332439318760896,0.3230521657503017
North Carolina,37145,Person County,13104,8416,21737,4688,0.6028430786217049,0.38717394304641856,0.21566913557528639
North Carolina,37147,Pitt County,38515,46607,86217,-8092,0.446721644223297,0.5405778442766508,-0.09385620005335377
North Carolina,37149,Polk County,7643,4485,12253,3158,0.6237656084224271,0.36603280829184687,0.25773280013058025
North Carolina,37151,Randolph County,56589,15506,72788,41083,0.7774495796010331,0.213029620267077,0.5644199593339561
North Carolina,37153,Richmond County,11752,8676,20597,3076,0.570568529397485,0.4212263921930378,0.14934213720444722
North Carolina,37155,Robeson County,26012,18094,44384,7918,0.5860670511896179,0.4076694304253785,0.17839762076423937
North Carolina,37157,Rockingham County,30997,15811,47241,15186,0.6561461442391143,0.33468808873647893,0.3214580555026354
North Carolina,37159,Rowan County,49053,22889,72756,26164,0.6742124360877454,0.3145994832041344,0.359612952883611
North Carolina,37161,Rutherford County,24631,9049,34076,15582,0.722825448996361,0.26555346871698554,0.4572719802793755
North Carolina,37163,Sampson County,17330,10832,28394,6498,0.6103402127209974,0.38148904698175673,0.22885116573924064
North Carolina,37165,Scotland County,7399,7137,14632,262,0.5056724986331329,0.4877665390924002,0.017905959540732708
North Carolina,37167,Stanly County,25297,8037,33624,17260,0.7523495122531525,0.23902569593147752,0.513323816321675
North Carolina,37169,Stokes County,19997,5258,25525,14739,0.7834280117531831,0.2059941234084231,0.5774338883447601
North Carolina,37171,Surry County,27344,8635,36290,18709,0.7534858087627445,0.23794433728299808,0.5155414714797464
North Carolina,37173,Swain County,4152,2765,7026,1387,0.5909479077711358,0.39353828636493027,0.19740962140620555
North Carolina,37175,Transylvania County,11578,8413,20253,3165,0.5716683948057077,0.41539525008640693,0.15627314471930082
North Carolina,37177,Tyrrell County,1043,757,1812,286,0.57560706401766,0.4177704194260486,0.15783664459161145
North Carolina,37179,Union County,79778,48199,129475,31579,0.6161652828731415,0.37226491600695116,0.24390036686619038
North Carolina,37181,Vance County,8385,12412,20948,-4027,0.40027687607408824,0.5925147985487875,-0.19223792247469929
North Carolina,37183,Wake County,223466,388686,624049,-165220,0.3580904704598517,0.6228453214411048,-0.2647548509812531
North Carolina,37185,Warren County,3739,6344,10207,-2605,0.3663172332712844,0.6215342412070148,-0.25521700793573043
North Carolina,37187,Washington County,2778,3387,6191,-609,0.4487158778872557,0.5470844774672913,-0.09836859958003558
North Carolina,37189,Watauga County,14332,16925,31771,-2593,0.451103207327437,0.5327185168864688,-0.08161530955903179
North Carolina,37191,Wayne County,30505,23986,55091,6519,0.5537202083824945,0.4353887204806593,0.11833148790183518
North Carolina,37193,Wilkes County,27397,7445,35197,19952,0.7783902037105435,0.21152370940705173,0.5668664943034918
North Carolina,37195,Wilson County,19473,20579,40446,-1106,0.48145675715769176,0.508801859269149,-0.027345102111457242
North Carolina,37197,Yadkin County,15861,3744,19794,12117,0.801303425280388,0.18914822673537435,0.6121551985450137
North Carolina,37199,Yancey County,7481,3678,11282,3803,0.6630916504165928,0.32600602730012407,0.3370856231164687
North Dakota,38001,Adams County,978,258,1266,720,0.7725118483412322,0.2037914691943128,0.5687203791469194
North Dakota,38003,Barnes County,3532,1800,5507,1732,0.6413655347739241,0.3268567278009806,0.31450880697294353
North Dakota,38005,Benson County,1090,817,1952,273,0.5584016393442623,0.41854508196721313,0.13985655737704922
North Dakota,38007,Billings County,539,72,633,467,0.8515007898894155,0.11374407582938388,0.7377567140600316
North Dakota,38009,Bottineau County,2563,819,3456,1744,0.7416087962962963,0.23697916666666666,0.5046296296296297
North Dakota,38011,Bowman County,1382,227,1643,1155,0.8411442483262325,0.13816189896530737,0.7029823493609251
North Dakota,38013,Burke County,1022,196,1332,826,0.7672672672672672,0.14714714714714713,0.6201201201201201
North Dakota,38015,Burleigh County,34588,14226,50465,20362,0.6853859110274447,0.2818983453878926,0.4034875656395521
North Dakota,38017,Cass County,42567,40219,85906,2348,0.49550671664377344,0.4681745163318045,0.027332200311968924
North Dakota,38019,Cavalier County,1499,474,2020,1025,0.7420792079207921,0.23465346534653464,0.5074257425742574
North Dakota,38021,Dickey County,1732,602,2408,1130,0.7192691029900332,0.25,0.4692691029900332
North Dakota,38023,Divide County,899,265,1197,634,0.7510442773600668,0.22138680033416874,0.5296574770258982
North Dakota,38025,Dunn County,1945,338,2328,1607,0.8354810996563574,0.14518900343642613,0.6902920962199313
North Dakota,38027,Eddy County,851,382,1257,469,0.6770087509944311,0.3038981702466189,0.3731105807478122
North Dakota,38029,Emmons County,1735,237,2006,1498,0.8649052841475573,0.11814556331006978,0.7467597208374875
North Dakota,38031,Foster County,1338,369,1748,969,0.7654462242562929,0.21109839816933637,0.5543478260869565
North Dakota,38033,Golden Valley County,870,136,1024,734,0.849609375,0.1328125,0.716796875
North Dakota,38035,Grand Forks County,16963,12856,30915,4107,0.5486980430211871,0.4158499110464176,0.13284813197476947
North Dakota,38037,Grant County,1132,207,1367,925,0.8280907095830286,0.15142648134601316,0.6766642282370154
North Dakota,38039,Griggs County,906,308,1248,598,0.7259615384615384,0.2467948717948718,0.47916666666666663
North Dakota,38041,Hettinger County,1086,195,1306,891,0.8315467075038285,0.14931087289433384,0.6822358346094947
North Dakota,38043,Kidder County,1206,221,1450,985,0.8317241379310345,0.15241379310344827,0.6793103448275862
North Dakota,38045,LaMoure County,1633,526,2206,1107,0.7402538531278332,0.2384406165004533,0.5018132366273799
North Dakota,38047,Logan County,923,125,1066,798,0.8658536585365854,0.11726078799249531,0.7485928705440901
North Dakota,38049,McHenry County,2345,559,2974,1786,0.7885003362474782,0.18796234028244788,0.6005379959650303
North Dakota,38051,McIntosh County,1147,259,1447,888,0.7926744989633725,0.17899101589495509,0.6136834830684175
North Dakota,38053,McKenzie County,4476,813,5412,3663,0.8270509977827051,0.15022172949002216,0.6768292682926829
North Dakota,38055,McLean County,4169,1216,5491,2953,0.7592423966490621,0.22145328719723184,0.5377891094518303
North Dakota,38057,Mercer County,3850,703,4668,3147,0.824764353041988,0.15059982862039417,0.6741645244215939
North Dakota,38059,Morton County,12234,3865,16603,8369,0.7368547852797687,0.232789254953924,0.5040655303258447
North Dakota,38061,Mountrail County,2806,1251,4142,1555,0.6774505070014486,0.3020280057943023,0.3754225012071463
North Dakota,38063,Nelson County,1139,585,1774,554,0.6420518602029313,0.3297632468996618,0.31228861330326946
North Dakota,38065,Oliver County,917,127,1063,790,0.8626528692380057,0.11947318908748825,0.7431796801505174
North Dakota,38067,Pembina County,2435,783,3303,1652,0.7372085982440206,0.23705722070844687,0.5001513775355737
North Dakota,38069,Pierce County,1637,569,2378,1068,0.6883936080740117,0.2392767031118587,0.44911690496215306
North Dakota,38071,Ramsey County,3570,1636,5362,1934,0.6657963446475196,0.3051100335695636,0.36068631107795596
North Dakota,38073,Ransom County,1411,942,2443,469,0.5775685632419156,0.38559148587801884,0.1919770773638968
North Dakota,38075,Renville County,1053,218,1305,835,0.8068965517241379,0.16704980842911876,0.6398467432950191
North Dakota,38077,Richland County,5035,2495,7757,2540,0.6490911434833054,0.3216449658373082,0.3274461776459972
North Dakota,38079,Rolette County,1253,2475,3791,-1222,0.3305196518069111,0.6528620416776576,-0.3223423898707465
North Dakota,38081,Sargent County,1286,812,2313,474,0.5559878945092953,0.3510592304366623,0.204928664072633
North Dakota,38083,Sheridan County,688,104,812,584,0.8472906403940886,0.12807881773399016,0.7192118226600985
North Dakota,38085,Sioux County,257,804,1185,-547,0.2168776371308017,0.6784810126582278,-0.46160337552742614
North Dakota,38087,Slope County,379,44,426,335,0.8896713615023474,0.10328638497652583,0.7863849765258215
North Dakota,38089,Stark County,12091,2490,15019,9601,0.8050469405419801,0.1657899993341767,0.6392569412078034
North Dakota,38091,Steele County,649,392,1085,257,0.5981566820276498,0.36129032258064514,0.23686635944700468
North Dakota,38093,Stutsman County,6981,2670,9939,4311,0.7023845457289466,0.26863869604587987,0.43374584968306673
North Dakota,38095,Towner County,828,317,1172,511,0.7064846416382252,0.27047781569965873,0.4360068259385665
North Dakota,38097,Traill County,2519,1491,4131,1028,0.6097797143548778,0.3609295570079884,0.24885015734688937
North Dakota,38099,Walsh County,3309,1329,4762,1980,0.6948761024779504,0.2790844183116338,0.4157916841663166
North Dakota,38101,Ward County,19921,7264,28159,12657,0.7074469974075784,0.2579637060975177,0.44948329131006076
North Dakota,38103,Wells County,1891,442,2372,1449,0.7972175379426644,0.18634064080944351,0.6108768971332208
North Dakota,38105,Williams County,11707,2157,14285,9550,0.8195309765488275,0.15099754987749386,0.6685334266713336
Ohio,39001,Adams County,9660,2130,11905,7530,0.8114237715245695,0.17891642167156657,0.6325073498530029
Ohio,39003,Allen County,32052,13611,46362,18441,0.6913420473663776,0.2935809499158794,0.3977610974504982
Ohio,39005,Ashland County,19002,6448,25883,12554,0.73414982807248,0.2491210447011552,0.48502878337132477
Ohio,39007,Ashtabula County,26225,16207,43253,10018,0.6063163248791992,0.3747023327861651,0.23161399209303407
Ohio,39009,Athens County,10386,14047,24876,-3661,0.41751085383502173,0.5646808168515839,-0.14716996301656216
Ohio,39011,Auglaize County,20451,4583,25396,15868,0.8052842967396441,0.18046148999842496,0.6248228067412191
Ohio,39013,Belmont County,23092,9007,32534,14085,0.7097805372840721,0.27684883506485525,0.43293170221921684
Ohio,39015,Brown County,16032,4326,20586,11706,0.7787816962984553,0.21014281550568348,0.5686388807927718
Ohio,39017,Butler County,111722,67729,182034,43993,0.6137424876671391,0.37206785545557425,0.24167463221156488
Ohio,39019,Carroll County,10525,3206,13957,7319,0.754101884359103,0.22970552410976572,0.5243963602493372
Ohio,39021,Champaign County,14086,4946,19369,9140,0.7272445660591668,0.25535649749599876,0.471888068563168
Ohio,39023,Clark County,38217,23625,62870,14592,0.607873389533959,0.37577540957531413,0.23209797995864484
Ohio,39025,Clermont County,73077,33505,108531,39572,0.67332835779639,0.30871363942099495,0.36461471837539505
Ohio,39027,Clinton County,15061,4556,19940,10505,0.7553159478435306,0.22848545636910733,0.5268304914744233
Ohio,39029,Columbiana County,35124,13183,49169,21941,0.7143525392015294,0.2681160894059265,0.4462364497956029
Ohio,39031,Coshocton County,11982,4057,16348,7925,0.7329336921947639,0.24816491313922193,0.48476877905554194
Ohio,39033,Crawford County,15043,4831,20222,10212,0.7438927900306597,0.2388982296508753,0.5049945603797844
Ohio,39035,Cuyahoga County,195089,402315,605268,-207226,0.32231837797471535,0.6646890303138444,-0.34237065233912906
Ohio,39037,Darke County,21569,4668,26621,16901,0.8102250103301905,0.1753502873671162,0.6348747229630742
Ohio,39039,Defiance County,12778,5870,19032,6908,0.6713955443463641,0.3084279108869273,0.3629676334594368
Ohio,39041,Delaware County,65163,56961,124004,8202,0.525491113189897,0.45934808554562756,0.06614302764426949
Ohio,39043,Erie County,21724,17142,39523,4582,0.5496546314804038,0.43372213647749414,0.1159324950029097
Ohio,39045,Fairfield County,49714,30634,81591,19080,0.609307399100391,0.37545807748403626,0.23384932161635474
Ohio,39047,Fayette County,9220,2911,12305,6309,0.749288906948395,0.23657049979683056,0.5127184071515645
Ohio,39049,Franklin County,203154,391584,606022,-188430,0.33522545386141095,0.6461547600582157,-0.31092930619680476
Ohio,39051,Fulton County,15396,6545,22299,8851,0.690434548634468,0.2935109197721871,0.3969236288622809
Ohio,39053,Gallia County,10289,2911,13358,7378,0.7702500374307532,0.2179218445875131,0.5523281928432401
Ohio,39055,Geauga County,33581,20980,55381,12601,0.6063631931528863,0.37883028475469926,0.22753290839818707
Ohio,39057,Greene County,50937,34023,86616,16914,0.5880784150734275,0.39280271543363815,0.19527569963978936
Ohio,39059,Guernsey County,13077,4498,17806,8579,0.7344153656070987,0.25261147927664834,0.4818038863304504
Ohio,39061,Hamilton County,173015,238101,417574,-65086,0.4143337468328967,0.5702007308884174,-0.15586698405552069
Ohio,39063,Hancock County,25796,11535,37999,14261,0.6788599699992105,0.30356062001631623,0.37529934998289427
Ohio,39065,Hardin County,9698,3025,12954,6673,0.7486490659255828,0.23351860429211055,0.5151304616334722
Ohio,39067,Harrison County,5668,1742,7500,3926,0.7557333333333334,0.23226666666666668,0.5234666666666667
Ohio,39069,Henry County,10273,3995,14482,6278,0.7093633476039221,0.2758596878884132,0.43350365971550886
Ohio,39071,Highland County,15369,3741,19303,11628,0.796197482256644,0.19380407190592136,0.6023934103507227
Ohio,39073,Hocking County,9554,3836,13786,5718,0.6930219062817351,0.2782533004497316,0.4147686058320035
Ohio,39075,Holmes County,10645,1981,12809,8664,0.8310562885471153,0.15465688187992818,0.6763994066671871
Ohio,39077,Huron County,18537,7643,26628,10894,0.6961469130238847,0.28702869160282407,0.4091182214210606
Ohio,39079,Jackson County,10804,3193,14160,7611,0.7629943502824859,0.22549435028248588,0.5375
Ohio,39081,Jefferson County,22309,9823,32572,12486,0.6849134225715339,0.30157804249048265,0.3833353800810512
Ohio,39083,Knox County,21825,8433,30703,13392,0.7108425886721167,0.2746637136436179,0.4361788750284988
Ohio,39085,Lake County,71615,54337,127867,17278,0.5600741395356112,0.42494936144587736,0.1351247780897339
Ohio,39087,Lawrence County,19759,7353,27427,12406,0.7204214824807671,0.2680934845225508,0.4523279979582163
Ohio,39089,Licking County,57965,32324,91830,25641,0.6312207339649352,0.3519982576500054,0.27922247631492975
Ohio,39091,Logan County,17625,4990,22985,12635,0.7668044376767457,0.21709810746138786,0.5497063302153578
Ohio,39093,Lorain County,76719,72792,151988,3927,0.5047701134300077,0.4789325473063663,0.025837566123641353
Ohio,39095,Lucas County,79628,111989,194882,-32361,0.4085959708952084,0.5746503012079104,-0.166054330312702
Ohio,39097,Madison County,13445,5558,19309,7887,0.6963074214097054,0.2878450463514423,0.40846237505826305
Ohio,39099,Mahoning County,58601,56346,116565,2255,0.5027323810749368,0.4833869514862952,0.019345429588641605
Ohio,39101,Marion County,18526,8089,27126,10437,0.68296099682961,0.2982009879820099,0.3847600088476001
Ohio,39103,Medina County,63451,39326,104378,24125,0.6078962999865872,0.3767652187242522,0.231131081262335
Ohio,39105,Meigs County,8163,2452,10764,5711,0.7583612040133779,0.22779635823114083,0.5305648457822371
Ohio,39107,Mercer County,19145,3981,23426,15164,0.8172543327926236,0.16993938359088193,0.6473149492017417
Ohio,39109,Miami County,40531,15420,56968,25111,0.7114695969667182,0.2706782755231007,0.4407913214436175
Ohio,39111,Monroe County,5392,1597,7066,3795,0.7630908576280782,0.22601188791395416,0.537078969714124
Ohio,39113,Montgomery County,126085,131592,262560,-5507,0.4802140463132236,0.5011882998171846,-0.020974253503960982
Ohio,39115,Morgan County,4932,1703,6721,3229,0.7338193721172445,0.25338491295938104,0.4804344591578634
Ohio,39117,Morrow County,13784,3988,18088,9796,0.7620521892967713,0.22047766475011057,0.5415745245466608
Ohio,39119,Muskingum County,27334,11755,39693,15579,0.6886352757413146,0.29614793540422746,0.3924873403370871
Ohio,39121,Noble County,5024,1156,6221,3868,0.8075872046294807,0.18582221507796173,0.621764989551519
Ohio,39123,Ottawa County,14285,8847,23525,5438,0.6072263549415515,0.3760680127523911,0.23115834218916043
Ohio,39125,Paulding County,6927,2172,9280,4755,0.7464439655172413,0.23405172413793104,0.5123922413793103
Ohio,39127,Perry County,11959,4006,16179,7953,0.7391680573583039,0.2476049199579702,0.49156313740033375
Ohio,39129,Pickaway County,20059,7167,27630,12892,0.7259862468331524,0.25939196525515745,0.46659428157799493
Ohio,39131,Pike County,8872,3051,12063,5821,0.7354721047832214,0.25292215866699824,0.4825499461162232
Ohio,39133,Portage County,45034,34935,81280,10099,0.5540600393700787,0.429810531496063,0.12424950787401573
Ohio,39135,Preble County,16697,4435,21437,12262,0.778886971124691,0.20688529178523113,0.5720016793394598
Ohio,39137,Putnam County,16218,3152,19671,13066,0.8244624065883789,0.1602358802297799,0.664226526358599
Ohio,39139,Richland County,40534,17231,58601,23303,0.6916946809781404,0.2940393508643197,0.39765533011382065
Ohio,39141,Ross County,21687,10345,32531,11342,0.6666564200301252,0.3180043650671667,0.3486520549629584
Ohio,39143,Sandusky County,18487,10391,29490,8096,0.626890471346219,0.35235673109528654,0.27453374025093247
Ohio,39145,Scioto County,21926,8876,31146,13050,0.7039748282283439,0.2849804148205227,0.4189944134078212
Ohio,39147,Seneca County,16739,8147,25322,8592,0.6610457309849143,0.3217360398072822,0.33930969117763204
Ohio,39149,Shelby County,19988,4399,24785,15589,0.8064555174500706,0.17748638289287877,0.6289691345571918
Ohio,39151,Stark County,108610,74336,185714,34274,0.5848239766522718,0.40027138503290005,0.18455259161937176
Ohio,39153,Summit County,122023,148151,274768,-26128,0.4440946543993478,0.5391857858265883,-0.09509113142724046
Ohio,39155,Trumbull County,53756,43534,98677,10222,0.5447672709952673,0.4411767686492293,0.10359050234603806
Ohio,39157,Tuscarawas County,29519,12643,42820,16876,0.6893741242410089,0.29525922466137317,0.3941148995796357
Ohio,39159,Union County,21233,10985,32838,10248,0.6465984530117547,0.3345209817893903,0.31207747122236434
Ohio,39161,Van Wert County,11470,3026,14767,8444,0.7767319022143969,0.20491636757635268,0.5718155346380442
Ohio,39163,Vinton County,4525,1306,5902,3219,0.7666892578786851,0.22128092172145036,0.5454083361572348
Ohio,39165,Warren County,85069,45040,132391,40029,0.6425587842073857,0.3402043945585425,0.30235438964884315
Ohio,39167,Washington County,21798,9114,31382,12684,0.6946020011471544,0.2904212605952457,0.4041807405519087
Ohio,39169,Wayne County,33618,24040,58342,9578,0.5762229611600562,0.4120530664015632,0.16416989475849303
Ohio,39171,Williams County,13218,4726,18290,8492,0.7226899945325315,0.2583925642427556,0.4642974302897759
Ohio,39173,Wood County,34815,29797,65860,5018,0.5286213179471606,0.45242939568782264,0.07619192225933796
Ohio,39175,Wyandot County,8248,2690,11122,5558,0.7415932386261463,0.2418629742852005,0.4997302643409458
Oklahoma,40001,Adair County,5585,1387,7108,4198,0.7857343837929094,0.19513224535734383,0.5906021384355655
Oklahoma,40003,Alfalfa County,1978,232,2262,1746,0.874447391688771,0.10256410256410256,0.7718832891246684
Oklahoma,40005,Atoka County,4557,765,5389,3792,0.8456114306921507,0.14195583596214512,0.7036555947300056
Oklahoma,40007,Beaver County,1968,190,2178,1778,0.9035812672176309,0.08723599632690542,0.8163452708907255
Oklahoma,40009,Beckham County,6767,1048,7948,5719,0.8514091595369905,0.1318570709612481,0.7195520885757424
Oklahoma,40011,Blaine County,3136,688,3901,2448,0.803896436811074,0.17636503460651115,0.6275314022045628
Oklahoma,40013,Bryan County,12344,3323,15976,9021,0.7726589884827241,0.20799949924887332,0.5646594892338508
Oklahoma,40015,Caddo County,7013,2670,9859,4343,0.7113297494674916,0.2708185414342225,0.4405112080332691
Oklahoma,40017,Canadian County,43550,16742,61940,26808,0.7030997739748144,0.2702938327413626,0.4328059412334518
Oklahoma,40019,Carter County,14699,4470,19479,10229,0.7546075260536989,0.22947789927614354,0.5251296267775554
Oklahoma,40021,Cherokee County,11223,6027,17714,5196,0.6335666704301682,0.34023935869933386,0.2933273117308344
Oklahoma,40023,Choctaw County,4698,1082,5832,3616,0.8055555555555556,0.1855281207133059,0.6200274348422496
Oklahoma,40025,Cimarron County,970,70,1054,900,0.920303605313093,0.06641366223908918,0.8538899430740038
Oklahoma,40027,Cleveland County,66677,49827,119778,16850,0.5566715089582394,0.41599458999148425,0.1406769189667551
Oklahoma,40029,Coal County,2091,374,2524,1717,0.8284469096671949,0.14817749603803487,0.68026941362916
Oklahoma,40031,Comanche County,20905,13747,35631,7158,0.5867082035306335,0.38581572226432037,0.2008924812663131
Oklahoma,40033,Cotton County,2117,393,2572,1724,0.823094867807154,0.15279937791601866,0.6702954898911353
Oklahoma,40035,Craig County,4686,1217,6032,3469,0.7768567639257294,0.20175729442970822,0.5750994694960212
Oklahoma,40037,Creek County,23294,6577,30505,16717,0.763612522537289,0.21560399934436977,0.5480085231929192
Oklahoma,40039,Custer County,8060,2369,10691,5691,0.7539051538677393,0.22158825180057992,0.5323169020671593
Oklahoma,40041,Delaware County,13557,3472,17245,10085,0.7861409104088142,0.20133371991881704,0.5848071904899972
Oklahoma,40043,Dewey County,2124,214,2359,1910,0.9003815175922001,0.0907164052564646,0.8096651123357355
Oklahoma,40045,Ellis County,1688,162,1873,1526,0.9012279765082755,0.08649225840896957,0.8147357180993059
Oklahoma,40047,Garfield County,16970,4919,22430,12051,0.7565760142666073,0.2193045028979046,0.5372715113687027
Oklahoma,40049,Garvin County,8878,1865,10922,7013,0.8128547885002747,0.17075627174510163,0.642098516755173
Oklahoma,40051,Grady County,18538,4144,23101,14394,0.8024760832864378,0.17938617375871174,0.623089909527726
Oklahoma,40053,Grant County,1916,280,2226,1636,0.8607367475292004,0.12578616352201258,0.7349505840071878
Oklahoma,40055,Greer County,1605,328,1973,1277,0.8134820070957932,0.16624429802331475,0.6472377090724785
Oklahoma,40057,Harmon County,747,177,933,570,0.8006430868167203,0.18971061093247588,0.6109324758842444
Oklahoma,40059,Harper County,1327,136,1487,1191,0.8924008069939475,0.09145931405514458,0.8009414929388029
Oklahoma,40061,Haskell County,4165,783,5014,3382,0.8306741124850419,0.15616274431591542,0.6745113681691264
Oklahoma,40063,Hughes County,3875,919,4857,2956,0.7978175828700844,0.18921144739551163,0.6086061354745728
Oklahoma,40065,Jackson County,6392,1646,8221,4746,0.7775209828488019,0.2002189514657584,0.5773020313830435
Oklahoma,40067,Jefferson County,2026,319,2385,1707,0.8494758909853249,0.13375262054507336,0.7157232704402516
Oklahoma,40069,Johnston County,3441,738,4251,2703,0.8094565984474241,0.17360621030345802,0.6358503881439661
Oklahoma,40071,Kay County,12834,4040,17249,8794,0.7440431329352426,0.23421647631746767,0.5098266566177749
Oklahoma,40073,Kingfisher County,5521,854,6465,4667,0.8539829853054911,0.13209590100541377,0.7218870843000773
Oklahoma,40075,Kiowa County,2673,699,3427,1974,0.7799824919754887,0.2039684855558798,0.576014006419609
Oklahoma,40077,Latimer County,3437,762,4249,2675,0.8088962108731467,0.179336314426924,0.6295598964462227
Oklahoma,40079,Le Flore County,15213,3299,18805,11914,0.8089869715501197,0.1754320659399096,0.6335549056102101
Oklahoma,40081,Lincoln County,12013,2609,14888,9404,0.8068914562063407,0.17524180548092425,0.6316496507254165
Oklahoma,40083,Logan County,15608,5455,21574,10153,0.7234634282006118,0.2528506535644758,0.47061277463613604
Oklahoma,40085,Love County,3305,711,4076,2594,0.8108439646712463,0.17443572129538765,0.6364082433758587
Oklahoma,40087,McClain County,15295,3582,19236,11713,0.7951237263464338,0.18621334996880848,0.6089103763776254
Oklahoma,40089,McCurtain County,9485,1858,11467,7627,0.8271561873201361,0.16203017354146682,0.6651260137786692
Oklahoma,40091,McIntosh County,6172,2031,8335,4141,0.740491901619676,0.24367126574685063,0.49682063587282543
Oklahoma,40093,Major County,3084,320,3467,2764,0.8895298528987597,0.0922988174214018,0.797231035477358
Oklahoma,40095,Marshall County,4891,1100,6064,3791,0.8065633245382586,0.18139841688654354,0.6251649076517151
Oklahoma,40097,Mayes County,12749,3581,16626,9168,0.766811018886082,0.21538554071935523,0.5514254781667268
Oklahoma,40099,Murray County,4612,1156,5894,3456,0.7824906684764167,0.19613165931455717,0.5863590091618596
Oklahoma,40101,Muskogee County,16526,8027,25081,8499,0.6589051473226746,0.32004306048403175,0.33886208683864283
Oklahoma,40103,Noble County,3821,1003,4938,2818,0.7737950587282301,0.20311867152693397,0.5706763872012961
Oklahoma,40105,Nowata County,3610,712,4391,2898,0.8221361876565703,0.1621498519699385,0.6599863356866318
Oklahoma,40107,Okfuskee County,3058,896,4038,2162,0.7573055968301139,0.2218920257553244,0.5354135710747895
Oklahoma,40109,Oklahoma County,145050,141724,294740,3326,0.4921286557644025,0.480844133812852,0.011284521951550497
Oklahoma,40111,Okmulgee County,9668,4357,14313,5311,0.6754698525815692,0.30440857961293927,0.37106127296862995
Oklahoma,40113,Osage County,14121,6002,20538,8119,0.6875547765118317,0.2922387769013536,0.39531599961047814
Oklahoma,40115,Ottawa County,8545,2686,11438,5859,0.7470711662878126,0.2348312642070292,0.5122399020807833
Oklahoma,40117,Pawnee County,5267,1363,6786,3904,0.7761567933981727,0.20085470085470086,0.5753020925434718
Oklahoma,40119,Payne County,17813,10904,29643,6909,0.6009175859393449,0.3678440103903114,0.23307357554903346
Oklahoma,40121,Pittsburg County,13851,3768,17924,10083,0.7727627761660344,0.21022093282749385,0.5625418433385405
Oklahoma,40123,Pontotoc County,10805,4117,15320,6688,0.7052872062663186,0.268733681462141,0.4365535248041776
Oklahoma,40125,Pottawatomie County,20240,7275,28185,12965,0.7181124711726096,0.2581160191591272,0.4599964520134824
Oklahoma,40127,Pushmataha County,4016,668,4739,3348,0.8474361679679258,0.1409580080185693,0.7064781599493565
Oklahoma,40129,Roger Mills County,1629,168,1834,1461,0.8882224645583424,0.0916030534351145,0.7966194111232279
Oklahoma,40131,Rogers County,34031,9589,44553,24442,0.7638318407290193,0.21522680852018944,0.5486050322088298
Oklahoma,40133,Seminole County,6011,2150,8337,3861,0.7210027587861341,0.2578865299268322,0.46311622885930187
Oklahoma,40135,Sequoyah County,12113,3035,15386,9078,0.7872741453269205,0.1972572468477837,0.5900168984791369
Oklahoma,40137,Stephens County,15560,3154,19057,12406,0.8164978747966627,0.16550348953140578,0.6509943852652569
Oklahoma,40139,Texas County,4505,894,5521,3611,0.8159753667813802,0.16192718710378554,0.6540481796775947
Oklahoma,40141,Tillman County,2076,597,2708,1479,0.7666174298375185,0.22045790251107827,0.5461595273264401
Oklahoma,40143,Tulsa County,150574,108996,266678,41578,0.5646285032886103,0.4087176295007462,0.15591087378786406
Oklahoma,40145,Wagoner County,26165,8464,35338,17701,0.7404210764615994,0.23951553568396627,0.500905540777633
Oklahoma,40147,Washington County,17076,5790,23501,11286,0.7266073784094293,0.24637249478745585,0.48023488362197353
Oklahoma,40149,Washita County,4086,598,4777,3488,0.855348545111995,0.12518316935315052,0.7301653757588444
Oklahoma,40151,Woods County,2993,591,3678,2402,0.813757476889614,0.16068515497553018,0.6530723219140838
Oklahoma,40153,Woodward County,6611,1005,7785,5606,0.8491971740526654,0.12909441233140656,0.7201027617212588
Oregon,41001,Baker County,7316,2332,9878,4984,0.7406357562259567,0.23608017817371937,0.5045555780522373
Oregon,41003,Benton County,14647,35438,52134,-20791,0.28094909272259944,0.6797483408140561,-0.39879924809145667
Oregon,41005,Clackamas County,108407,136782,253206,-28375,0.4281375638807927,0.5402004691831948,-0.11206290530240204
Oregon,41007,Clatsop County,10001,12740,23519,-2739,0.4252306645690718,0.5416896976912283,-0.1164590331221565
Oregon,41009,Columbia County,16779,13535,31518,3244,0.5323624595469255,0.4294371470270956,0.10292531251982989
Oregon,41011,Coos County,21488,14024,36484,7464,0.5889705076197785,0.38438767678982566,0.20458283082995288
Oregon,41013,Crook County,11103,3715,15165,7388,0.7321463897131553,0.24497197494230136,0.4871744147708539
Oregon,41015,Curry County,8441,6023,14843,2418,0.5686855756922455,0.40578050259381526,0.16290507309843028
Oregon,41017,Deschutes County,54183,64102,121732,-9919,0.44510071304176385,0.5265829855748694,-0.08148227253310553
Oregon,41019,Douglas County,42513,18780,63107,23733,0.6736653620042151,0.29758980778677485,0.37607555421744027
Oregon,41021,Gilliam County,830,323,1172,507,0.7081911262798635,0.27559726962457337,0.4325938566552901
Oregon,41023,Grant County,3537,923,4577,2614,0.7727769281188551,0.20166047629451606,0.571116451824339
Oregon,41025,Harney County,3465,890,4465,2575,0.7760358342665173,0.19932810750279956,0.5767077267637177
Oregon,41027,Hood River County,3858,8530,12745,-4672,0.3027069438995685,0.6692820714005492,-0.3665751275009807
Oregon,41029,Jackson County,63012,58386,125184,4626,0.5033550613496932,0.46640145705521474,0.03695360429447847
Oregon,41031,Jefferson County,7044,4306,11666,2738,0.6038059317675296,0.3691068061032059,0.23469912566432372
Oregon,41033,Josephine County,30954,17908,50205,13046,0.6165521362414103,0.35669754008564886,0.2598545961557614
Oregon,41035,Klamath County,25048,10260,36331,14788,0.6894387712972393,0.2824034571027497,0.4070353141944896
Oregon,41037,Lake County,3449,788,4336,2661,0.7954335793357934,0.18173431734317344,0.6136992619926199
Oregon,41039,Lane County,79208,132015,218521,-52807,0.3624731719148274,0.604129580223411,-0.2416564083085836
Oregon,41041,Lincoln County,12336,17248,30441,-4912,0.40524292894451563,0.5666042508458986,-0.16136132190138297
Oregon,41043,Linn County,42708,25893,71148,16815,0.6002698600101197,0.3639315230224321,0.23633833698768764
Oregon,41045,Malheur County,8101,3202,11653,4899,0.695185789067193,0.274779026860036,0.42040676220715695
Oregon,41047,Marion County,77292,78537,161287,-1245,0.4792202719376019,0.4869394309522776,-0.0077191590146756806
Oregon,41049,Morrow County,3557,1345,5060,2212,0.7029644268774704,0.2658102766798419,0.4371541501976285
Oregon,41051,Multnomah County,81868,363405,458395,-281537,0.17859706148627275,0.7927769718256089,-0.6141799103393362
Oregon,41053,Polk County,23259,22431,47279,828,0.4919520294422471,0.4744389686753104,0.017513060766936706
Oregon,41055,Sherman County,914,257,1197,657,0.7635756056808688,0.214703425229741,0.5488721804511278
Oregon,41057,Tillamook County,8306,7956,16725,350,0.4966218236173393,0.475695067264574,0.020926756352765308
Oregon,41059,Umatilla County,21002,10499,32539,10503,0.6454408555886783,0.32265896309044534,0.3227818924982329
Oregon,41061,Union County,10247,4227,14862,6020,0.6894765172924237,0.28441663302381914,0.4050598842686045
Oregon,41063,Wallowa County,3390,1619,5128,1771,0.6610764430577223,0.3157176287051482,0.3453588143525741
Oregon,41065,Wasco County,6965,6467,13904,498,0.5009349827387802,0.4651179516685846,0.035817031070195626
Oregon,41067,Washington County,98197,206972,316308,-108775,0.3104474120161362,0.6543369121236263,-0.34388950010749014
Oregon,41069,Wheeler County,710,216,963,494,0.7372793354101765,0.22429906542056074,0.5129802699896158
Oregon,41071,Yamhill County,28602,26401,57085,2201,0.5010423053341508,0.4624857668389244,0.038556538495226444
Pennsylvania,42001,Adams County,37009,17919,55814,19090,0.6630773641021965,0.32104848245959794,0.3420288816425986
Pennsylvania,42003,Allegheny County,274028,415737,700530,-141709,0.3911723980414829,0.5934606654961244,-0.2022882674546415
Pennsylvania,42005,Armstrong County,27112,8352,35881,18760,0.7556088180374014,0.23276943229006997,0.5228393857473315
Pennsylvania,42007,Beaver County,53886,37389,92767,16497,0.5808746644819818,0.40304203003223127,0.1778326344497505
Pennsylvania,42009,Bedford County,22529,4266,27018,18263,0.8338515064031387,0.15789473684210525,0.6759567695610333
Pennsylvania,42011,Berks County,105941,89530,198803,16411,0.5328943728213357,0.45034531672057265,0.08254905610076302
Pennsylvania,42013,Blair County,44714,17425,62898,27289,0.7108970078539858,0.27703583579764063,0.43386117205634517
Pennsylvania,42015,Bradford County,21514,7978,30056,13536,0.7157971785999467,0.26543784934788395,0.4503593292520628
Pennsylvania,42017,Bucks County,182742,198251,385933,-15509,0.47350705951551175,0.5136927912357845,-0.04018573172027273
Pennsylvania,42019,Butler County,73023,36534,111017,36489,0.657764126214904,0.3290847347703505,0.3286793914445535
Pennsylvania,42021,Cambria County,47885,21614,70418,26271,0.6800107926950496,0.30693856684370474,0.37307222585134486
Pennsylvania,42023,Cameron County,1771,634,2440,1137,0.7258196721311475,0.2598360655737705,0.46598360655737703
Pennsylvania,42025,Carbon County,21607,10990,33018,10617,0.6544006299594161,0.332848749167121,0.3215518807922951
Pennsylvania,42027,Centre County,36042,39718,77100,-3676,0.46747081712062255,0.5151491569390402,-0.047678339818417625
Pennsylvania,42029,Chester County,126844,179065,310650,-52221,0.4083180428134557,0.5764204088202157,-0.16810236600676004
Pennsylvania,42031,Clarion County,14363,4615,19234,9748,0.7467505459082874,0.23993969013205782,0.5068108557762295
Pennsylvania,42033,Clearfield County,28984,9598,39124,19386,0.7408240466209999,0.24532256415499437,0.4955014824660055
Pennsylvania,42035,Clinton County,11668,5406,17321,6262,0.6736331620576179,0.3121066912995785,0.3615264707580394
Pennsylvania,42037,Columbia County,19752,10289,30669,9463,0.6440379536339627,0.33548534350647236,0.3085526101274903
Pennsylvania,42039,Crawford County,27990,12584,41150,15406,0.6801944106925881,0.3058080194410693,0.37438639125151885
Pennsylvania,42041,Cumberland County,76149,61168,139711,14981,0.5450465603996822,0.43781806729606115,0.10722849310362109
Pennsylvania,42043,Dauphin County,65129,77387,144861,-12258,0.4495965097576297,0.5342155583628444,-0.08461904860521469
Pennsylvania,42045,Delaware County,116216,200911,321088,-84695,0.3619443890771377,0.6257194289415986,-0.2637750398644609
Pennsylvania,42047,Elk County,11993,4478,16751,7515,0.7159572562832069,0.26732732374186613,0.4486299325413408
Pennsylvania,42049,Erie County,65972,67471,135657,-1499,0.48631474969961,0.4973646770900138,-0.01104992739040378
Pennsylvania,42051,Fayette County,39956,19486,59952,20470,0.6664665065385642,0.32502668801708035,0.34143981852148386
Pennsylvania,42053,Forest County,1864,715,2621,1149,0.7111789393361313,0.2727966425028615,0.4383822968332698
Pennsylvania,42055,Franklin County,56628,22040,79904,34588,0.7087004405286343,0.27583099719663595,0.4328694433319984
Pennsylvania,42057,Fulton County,6660,1068,7807,5592,0.8530805687203792,0.13680030741642116,0.716280261303958
Pennsylvania,42059,Greene County,12436,4882,17494,7554,0.7108722990739682,0.27906710872299073,0.4318051903509775
Pennsylvania,42061,Huntingdon County,17059,5448,22844,11611,0.7467606373664857,0.23848713009980738,0.5082735072666783
Pennsylvania,42063,Indiana County,27832,12475,40835,15357,0.6815721807273173,0.30549773478633524,0.37607444594098205
Pennsylvania,42065,Jefferson County,17928,4498,22799,13430,0.7863502785209877,0.197289354796263,0.5890609237247247
Pennsylvania,42067,Juniata County,9648,2253,12058,7395,0.8001326919887212,0.18684690661801293,0.6132857853707082
Pennsylvania,42069,Lackawanna County,51501,61124,113975,-9623,0.4518622504935293,0.536293046720772,-0.08443079622724275
Pennsylvania,42071,Lancaster County,156938,112536,273527,44402,0.5737568868886801,0.4114255631071156,0.1623313237815645
Pennsylvania,42073,Lawrence County,29071,15557,45217,13514,0.6429219099011434,0.3440520158347524,0.298869894066391
Pennsylvania,42075,Lebanon County,45907,23412,70483,22495,0.6513201764964601,0.33216520295674135,0.3191549735397188
Pennsylvania,42077,Lehigh County,82134,95539,179770,-13405,0.45688379596150636,0.5314512988819047,-0.07456750292039832
Pennsylvania,42079,Luzerne County,84649,62983,149103,21666,0.567721642086343,0.4224126945802566,0.14530894750608642
Pennsylvania,42081,Lycoming County,40885,16722,58473,24163,0.6992116019359362,0.2859781437586578,0.4132334581772784
Pennsylvania,42083,McKean County,13892,5024,19195,8868,0.7237301380567857,0.26173482677780674,0.4619953112789789
Pennsylvania,42085,Mercer County,35282,20426,56420,14856,0.6253456221198157,0.3620347394540943,0.2633108826657214
Pennsylvania,42087,Mifflin County,16532,4560,21317,11972,0.7755312661256274,0.2139137777360792,0.5616174883895482
Pennsylvania,42089,Monroe County,37297,42102,80477,-4805,0.46344918423897513,0.5231556842327622,-0.05970649999378702
Pennsylvania,42091,Montgomery County,182907,313543,501561,-130636,0.36467548314163184,0.625134330619805,-0.2604588474781731
Pennsylvania,42093,Montour County,5842,3768,9812,2074,0.5953933958418264,0.3840195678760701,0.21137382796575627
Pennsylvania,42095,Northampton County,82830,84145,169403,-1315,0.4889523798279842,0.49671493421013796,-0.007762554382153786
Pennsylvania,42097,Northumberland County,28412,12414,41560,15998,0.6836381135707411,0.2987006737247353,0.3849374398460058
Pennsylvania,42099,Perry County,17879,5704,24032,12175,0.74396637816245,0.23735019973368843,0.5066161784287616
Pennsylvania,42101,Philadelphia County,126253,558264,690933,-432011,0.18272828190287627,0.8079857236519316,-0.6252574417490553
Pennsylvania,42103,Pike County,18979,12878,32179,6101,0.5897945865315889,0.4001988874731968,0.18959569905839208
Pennsylvania,42105,Potter County,7117,1686,8901,5431,0.7995730816762161,0.1894169194472531,0.610156162228963
Pennsylvania,42107,Schuylkill County,48100,20425,69649,27675,0.6906057516977989,0.2932561845826932,0.3973495671151057
Pennsylvania,42109,Snyder County,13816,4848,18945,8968,0.7292689363948271,0.2558986539984165,0.47337028239641066
Pennsylvania,42111,Somerset County,31105,8543,40093,22562,0.775821215673559,0.21307958995335843,0.5627416257202006
Pennsylvania,42113,Sullivan County,2622,921,3602,1701,0.7279289283731261,0.25569128262076624,0.4722376457523598
Pennsylvania,42115,Susquehanna County,14879,6084,21325,8795,0.6977256740914419,0.2852989449003517,0.41242672919109025
Pennsylvania,42117,Tioga County,15735,4953,21099,10782,0.7457699417033983,0.23475046210720887,0.5110194795961894
Pennsylvania,42119,Union County,12342,7377,20078,4965,0.614702659627453,0.3674170734136866,0.24728558621376634
Pennsylvania,42121,Venango County,18286,7475,26198,10811,0.6979922131460417,0.2853271242079548,0.41266508893808684
Pennsylvania,42123,Warren County,14020,5987,20401,8033,0.6872212146463409,0.29346600656830546,0.39375520807803543
Pennsylvania,42125,Washington County,71375,44712,117658,26663,0.6066310833092522,0.3800166584507641,0.2266144248584881
Pennsylvania,42127,Wayne County,18466,9135,27915,9331,0.661508149740283,0.3272434175174637,0.3342647322228193
Pennsylvania,42129,Westmoreland County,128304,70738,201805,57566,0.6357820668467085,0.3505264983523699,0.2852555684943386
Pennsylvania,42131,Wyoming County,9819,4642,14716,5177,0.6672329437347105,0.3154389779831476,0.35179396575156296
Pennsylvania,42133,York County,143260,85323,232733,57937,0.6155551640721342,0.3666132435022107,0.24894192056992348
Rhode Island,44001,Bristol County,9586,17701,27743,-8115,0.34552860180946543,0.6380348195941319,-0.29250621778466646
Rhode Island,44003,Kent County,41561,48474,91475,-6913,0.45434271658923203,0.5299152773981962,-0.07557256080896418
Rhode Island,44005,Newport County,15532,28878,45091,-13346,0.3444589829455989,0.6404382249229337,-0.2959792419773348
Rhode Island,44007,Providence County,101219,161674,266580,-60455,0.3796946507614975,0.6064746042463801,-0.2267799534848826
Rhode Island,44009,Washington County,29523,43598,74325,-14075,0.3972149344096872,0.5865859401278171,-0.18937100571812987
South Carolina,45001,Abbeville County,9343,5106,14552,4237,0.642042330951072,0.35087960417811986,0.29116272677295213
South Carolina,45003,Aiken County,51589,32275,85185,19314,0.6056113165463404,0.37888125843751835,0.22673005810882202
South Carolina,45005,Allendale County,835,2718,3593,-1883,0.23239632618981354,0.7564709156693571,-0.5240745894795436
South Carolina,45007,Anderson County,67565,27169,96093,40396,0.7031209349276222,0.28273651566711416,0.420384419260508
South Carolina,45009,Bamberg County,2417,4010,6482,-1593,0.3728787411292811,0.6186362233878433,-0.2457574822585622
South Carolina,45011,Barnwell County,5492,4720,10321,772,0.5321189807189226,0.45732002712915415,0.07479895358976846
South Carolina,45013,Beaufort County,53194,43419,97835,9775,0.5437113507435989,0.4437982317166658,0.09991311902693306
South Carolina,45015,Berkeley County,57397,45223,104458,12174,0.5494744299144153,0.4329299814279423,0.116544448486473
South Carolina,45017,Calhoun County,4305,3905,8291,400,0.519237727656495,0.4709926426245326,0.0482450850319624
South Carolina,45019,Charleston County,93297,121485,218857,-28188,0.42629205371543977,0.5550884824337353,-0.12879642871829555
South Carolina,45021,Cherokee County,18043,6983,25270,11060,0.714008705975465,0.27633557578155915,0.4376731301939058
South Carolina,45023,Chester County,8660,6941,15757,1719,0.5495970045059339,0.4405026337500793,0.10909437075585454
South Carolina,45025,Chesterfield County,11297,7431,18876,3866,0.5984848484848485,0.39367450731087095,0.20481034117397756
South Carolina,45027,Clarendon County,8361,8250,16733,111,0.4996713081933903,0.49303770991454016,0.006633598278850128
South Carolina,45029,Colleton County,10440,8602,19283,1838,0.5414095317118706,0.44609241300627495,0.09531711870559562
South Carolina,45031,Darlington County,16832,15220,32417,1612,0.5192337353857543,0.46950674029058825,0.04972699509516609
South Carolina,45033,Dillon County,6582,6436,13101,146,0.5024043966109457,0.49126020914434015,0.01114418746660556
South Carolina,45035,Dorchester County,41913,33824,77278,8089,0.5423665208726934,0.43769248686560214,0.1046740340070913
South Carolina,45037,Edgefield County,8184,4953,13304,3231,0.6151533373421527,0.372294046903187,0.2428592904389657
South Carolina,45039,Fairfield County,4625,7382,12136,-2757,0.38109756097560976,0.6082729070533949,-0.2271753460777851
South Carolina,45041,Florence County,32605,31149,64495,1456,0.5055430653539034,0.48296767191255136,0.02257539344135201
South Carolina,45043,Georgetown County,20487,15822,36668,4665,0.5587160466892113,0.4314934002399913,0.12722264644922
South Carolina,45045,Greenville County,150021,103030,258155,46991,0.5811276171292441,0.3991013151013926,0.18202630202785153
South Carolina,45047,Greenwood County,19431,12145,32006,7286,0.6071049178279073,0.3794601012310192,0.22764481659688812
South Carolina,45049,Hampton County,3905,5322,9303,-1417,0.41975706761259807,0.5720735246694615,-0.15231645705686342
South Carolina,45051,Horry County,118821,59180,179744,59641,0.6610568363895318,0.3292460388107531,0.33181079757877874
South Carolina,45053,Jasper County,7065,7162,14889,-97,0.47451138424340117,0.48102626099805224,-0.006514876754651067
South Carolina,45055,Kershaw County,20471,12699,33629,7772,0.6087305599333909,0.3776205061107972,0.23111005382259364
South Carolina,45057,Lancaster County,30312,18937,49868,11375,0.607844710034491,0.37974252025346916,0.22810218978102187
South Carolina,45059,Laurens County,20004,10159,30488,9845,0.656127000787195,0.3332130674363684,0.3229139333508266
South Carolina,45061,Lee County,3008,5329,8431,-2321,0.35677855533151465,0.6320721148143755,-0.2752935594828609
South Carolina,45063,Lexington County,92817,49301,144568,43516,0.6420300481434342,0.34102290963422055,0.3010071385092137
South Carolina,45065,McCormick County,2958,2687,5697,271,0.5192206424433913,0.47165174653326314,0.04756889591012814
South Carolina,45067,Marion County,5711,8872,14704,-3161,0.3883977149075082,0.6033732317736671,-0.2149755168661589
South Carolina,45069,Marlboro County,5044,6290,11446,-1246,0.4406779661016949,0.5495369561418836,-0.10885899004018867
South Carolina,45071,Newberry County,11443,6958,18631,4485,0.614191401427728,0.37346358220170683,0.24072781922602116
South Carolina,45073,Oconee County,29698,10414,40668,19284,0.7302547457460411,0.2560735713583161,0.474181174387725
South Carolina,45075,Orangeburg County,13603,27295,41205,-13692,0.33012983861181894,0.6624196092707195,-0.3322897706589006
South Carolina,45077,Pickens County,42907,13645,57546,29262,0.7456122058874639,0.237114656101206,0.5084975497862579
South Carolina,45079,Richland County,58313,132570,193822,-74257,0.3008585196726894,0.6839780829833558,-0.38311956331066643
South Carolina,45081,Saluda County,6210,2963,9274,3247,0.6696139745525124,0.31949536338149664,0.3501186111710157
South Carolina,45083,Spartanburg County,93560,52926,148655,40634,0.6293767448118126,0.3560324240691534,0.2733443207426592
South Carolina,45085,Sumter County,21000,27379,48920,-6379,0.42927228127555195,0.5596688470973017,-0.13039656582174974
South Carolina,45087,Union County,8183,4935,13257,3248,0.6172588066681753,0.3722561665535189,0.24500264011465644
South Carolina,45089,Williamsburg County,5532,10289,15985,-4757,0.3460744447919925,0.6436659368157648,-0.2975914920237723
South Carolina,45091,York County,82727,59008,144050,23719,0.5742936480388754,0.40963554321416173,0.16465810482471366
South Dakota,46003,Aurora County,1052,317,1405,735,0.7487544483985765,0.22562277580071174,0.5231316725978647
South Dakota,46005,Beadle County,4808,2107,7081,2701,0.6790001412229911,0.29755684225391893,0.3814432989690722
South Dakota,46007,Bennett County,694,466,1183,228,0.5866441251056635,0.39391377852916315,0.1927303465765004
South Dakota,46009,Bon Homme County,2235,721,3001,1514,0.7447517494168611,0.24025324891702765,0.5044985004998335
South Dakota,46011,Brookings County,8000,6110,14567,1890,0.5491865174709961,0.41944120271847324,0.12974531475252288
South Dakota,46013,Brown County,10580,6538,17547,4042,0.6029520715791873,0.37259930472445435,0.23035276685473294
South Dakota,46015,Brule County,1750,673,2490,1077,0.7028112449799196,0.27028112449799196,0.4325301204819277
South Dakota,46017,Buffalo County,183,352,549,-169,0.3333333333333333,0.6411657559198543,-0.30783242258652094
South Dakota,46019,Butte County,3731,939,4802,2792,0.7769679300291545,0.19554352353186172,0.5814244064972929
South Dakota,46021,Campbell County,747,117,873,630,0.8556701030927835,0.13402061855670103,0.7216494845360825
South Dakota,46023,Charles Mix County,2552,1177,3783,1375,0.6745968807824478,0.3111287338091462,0.36346814697330165
South Dakota,46025,Clark County,1373,437,1850,936,0.7421621621621621,0.23621621621621622,0.5059459459459459
South Dakota,46027,Clay County,2456,3083,5698,-627,0.431028431028431,0.5410670410670411,-0.11003861003861004
South Dakota,46029,Codington County,8958,3837,13161,5121,0.6806473672213358,0.29154319580578986,0.38910417141554593
South Dakota,46031,Corson County,647,622,1283,25,0.5042868277474669,0.4848012470771629,0.019485580670304037
South Dakota,46033,Custer County,3852,1522,5494,2330,0.7011285038223517,0.27702948671277755,0.42409901710957415
South Dakota,46035,Davison County,5613,2648,8454,2965,0.6639460610361959,0.3132245091081145,0.3507215519280814
South Dakota,46037,Day County,1869,1052,2964,817,0.6305668016194332,0.3549257759784076,0.27564102564102566
South Dakota,46039,Deuel County,1699,609,2350,1090,0.7229787234042553,0.2591489361702128,0.4638297872340425
South Dakota,46041,Dewey County,790,1131,1966,-341,0.40183112919633773,0.5752797558494405,-0.17344862665310273
South Dakota,46043,Douglas County,1468,216,1707,1252,0.8599882835383714,0.1265377855887522,0.7334504979496193
South Dakota,46045,Edmunds County,1538,417,1985,1121,0.7748110831234257,0.21007556675062972,0.5647355163727961
South Dakota,46047,Fall River County,2878,1053,4042,1825,0.7120237506185056,0.26051459673428995,0.4515091538842157
South Dakota,46049,Faulk County,964,198,1182,766,0.8155668358714044,0.16751269035532995,0.6480541455160744
South Dakota,46051,Grant County,2618,1056,3745,1562,0.6990654205607477,0.28197596795727636,0.41708945260347136
South Dakota,46053,Gregory County,1772,455,2259,1317,0.7844178840194777,0.2014165559982293,0.5830013280212484
South Dakota,46055,Haakon County,1026,105,1137,921,0.9023746701846965,0.09234828496042216,0.8100263852242744
South Dakota,46057,Hamlin County,2372,647,3083,1725,0.7693804735647097,0.20986052546221212,0.5595199481024976
South Dakota,46059,Hand County,1433,373,1836,1060,0.7805010893246187,0.20315904139433552,0.5773420479302832
South Dakota,46061,Hanson County,1793,557,2388,1236,0.7508375209380235,0.233249581239531,0.5175879396984925
South Dakota,46063,Harding County,748,49,813,699,0.9200492004920049,0.06027060270602706,0.8597785977859779
South Dakota,46065,Hughes County,5522,2953,8723,2569,0.6330390920554855,0.3385303221368795,0.294508769918606
South Dakota,46067,Hutchinson County,2944,762,3767,2182,0.7815237589593841,0.20228298380674276,0.5792407751526414
South Dakota,46069,Hyde County,564,136,710,428,0.7943661971830986,0.19154929577464788,0.6028169014084508
South Dakota,46071,Jackson County,738,359,1115,379,0.6618834080717488,0.3219730941704036,0.33991031390134524
South Dakota,46073,Jerauld County,721,270,1006,451,0.7166998011928429,0.268389662027833,0.44831013916500995
South Dakota,46075,Jones County,498,90,599,408,0.8313856427378965,0.15025041736227046,0.681135225375626
South Dakota,46077,Kingsbury County,1904,819,2779,1085,0.6851385390428212,0.2947103274559194,0.3904282115869018
South Dakota,46079,Lake County,3681,2068,5873,1613,0.6267665588285374,0.3521198705942449,0.2746466882342925
South Dakota,46081,Lawrence County,8753,4537,13828,4216,0.6329910326873012,0.32810240092565807,0.3048886317616431
South Dakota,46083,Lincoln County,19676,11981,32455,7695,0.6062548143583423,0.3691572947157603,0.23709751964258197
South Dakota,46085,Lyman County,1042,525,1597,517,0.6524733876017533,0.3287413901064496,0.32373199749530374
South Dakota,46087,McCook County,2068,769,2900,1299,0.713103448275862,0.26517241379310347,0.44793103448275856
South Dakota,46089,McPherson County,1075,222,1324,853,0.8119335347432024,0.16767371601208458,0.6442598187311178
South Dakota,46091,Marshall County,1287,858,2178,429,0.5909090909090909,0.3939393939393939,0.19696969696969702
South Dakota,46093,Meade County,9875,3285,13670,6590,0.7223847841989759,0.2403072421360644,0.48207754206291153
South Dakota,46095,Mellette County,449,298,769,151,0.5838751625487646,0.38751625487646296,0.19635890767230163
South Dakota,46097,Miner County,787,320,1138,467,0.6915641476274165,0.281195079086116,0.41036906854130045
South Dakota,46099,Minnehaha County,49249,40482,92326,8767,0.5334250373675887,0.43846803717262745,0.09495700019496128
South Dakota,46101,Moody County,1951,1179,3206,772,0.6085464753587024,0.367747972551466,0.24079850280723641
South Dakota,46102,Oglala Lakota County,297,2829,3200,-2532,0.0928125,0.8840625,-0.79125
South Dakota,46103,Pennington County,35063,20606,57518,14457,0.6096004728954414,0.35825306860461076,0.25134740429083063
South Dakota,46105,Perkins County,1401,239,1669,1162,0.8394248052726183,0.1431995206710605,0.6962252846015577
South Dakota,46107,Potter County,1139,227,1380,912,0.8253623188405798,0.1644927536231884,0.6608695652173914
South Dakota,46109,Roberts County,2404,1828,4307,576,0.5581611330392384,0.424425354074762,0.13373577896447641
South Dakota,46111,Sanborn County,905,257,1185,648,0.7637130801687764,0.2168776371308017,0.5468354430379747
South Dakota,46115,Spink County,2104,998,3163,1106,0.6651912741068606,0.31552323743281696,0.34966803667404367
South Dakota,46117,Stanley County,1203,421,1652,782,0.7282082324455206,0.25484261501210653,0.47336561743341404
South Dakota,46119,Sully County,726,185,930,541,0.7806451612903226,0.1989247311827957,0.5817204301075269
South Dakota,46121,Todd County,532,1963,2539,-1431,0.20953131153997637,0.773139031114612,-0.5636077195746356
South Dakota,46123,Tripp County,2161,495,2696,1666,0.8015578635014837,0.1836053412462908,0.6179525222551929
South Dakota,46125,Turner County,3290,1139,4548,2151,0.7233948988566403,0.2504397537379068,0.47295514511873354
South Dakota,46127,Union County,5949,2729,8864,3220,0.6711416967509025,0.3078745487364621,0.36326714801444043
South Dakota,46129,Walworth County,1966,565,2580,1401,0.762015503875969,0.2189922480620155,0.5430232558139534
South Dakota,46135,Yankton County,6581,4016,10900,2565,0.6037614678899083,0.36844036697247706,0.2353211009174312
South Dakota,46137,Ziebach County,404,481,906,-77,0.445916114790287,0.5309050772626932,-0.08498896247240623
Tennessee,47001,Anderson County,23163,11733,35527,11430,0.6519829988459481,0.3302558617389591,0.321727137106989
Tennessee,47003,Bedford County,14317,4443,19039,9874,0.7519827722044226,0.2333630968013026,0.5186196754031199
Tennessee,47005,Benton County,5661,1526,7250,4135,0.7808275862068965,0.21048275862068966,0.5703448275862069
Tennessee,47007,Bledsoe County,4725,971,5758,3754,0.8205974296630775,0.1686349426884335,0.651962486974644
Tennessee,47009,Blount County,47195,17834,66306,29361,0.7117757065725575,0.26896510119747835,0.44281060537507916
Tennessee,47011,Bradley County,35194,9849,45968,25345,0.7656195614340411,0.2142577445179255,0.5513618169161156
Tennessee,47013,Campbell County,12330,2438,14929,9892,0.8259093040391184,0.1633063165650747,0.6626029874740438
Tennessee,47015,Cannon County,5190,1261,6562,3929,0.7909174032307223,0.19216702224931423,0.5987503809814081
Tennessee,47017,Carroll County,9194,2558,11893,6636,0.7730597830656689,0.21508450348944758,0.5579752795762214
Tennessee,47019,Carter County,19873,4613,24868,15260,0.7991394563294193,0.18549943702750524,0.613640019301914
Tennessee,47021,Cheatham County,14328,5457,20091,8871,0.7131551440943706,0.27161415559205615,0.4415409885023145
Tennessee,47023,Chester County,5951,1411,7578,4540,0.7852995513328055,0.18619688572182633,0.5991026656109791
Tennessee,47025,Claiborne County,10598,2201,12935,8397,0.8193274062620797,0.17015848473134906,0.6491689215307306
Tennessee,47027,Clay County,2733,735,3506,1998,0.7795208214489446,0.2096406160867085,0.5698802053622362
Tennessee,47029,Cocke County,12182,2524,14870,9658,0.8192333557498319,0.16973772696704775,0.6494956287827842
Tennessee,47031,Coffee County,17863,5704,24313,12159,0.7347098260190021,0.23460700037017235,0.5001028256488298
Tennessee,47033,Crockett County,4673,1382,6114,3291,0.764311416421328,0.2260385999345764,0.5382728164867516
Tennessee,47035,Cumberland County,25167,6728,32307,18439,0.7789952641842325,0.2082520815922246,0.5707431825920078
Tennessee,47037,Davidson County,99415,197846,308325,-98431,0.3224357415065272,0.6416800454066326,-0.3192443039001054
Tennessee,47039,Decatur County,4229,904,5250,3325,0.8055238095238095,0.1721904761904762,0.6333333333333333
Tennessee,47041,DeKalb County,6663,1747,8501,4916,0.7837901423361957,0.20550523467827314,0.5782849076579226
Tennessee,47043,Dickson County,17619,6098,24342,11521,0.7238106975597732,0.2505135157341221,0.4732971818256511
Tennessee,47045,Dyer County,11766,3157,15074,8609,0.780549290168502,0.20943346158949183,0.5711158285790102
Tennessee,47047,Fayette County,15661,7000,22928,8661,0.6830512909979065,0.3053035589672017,0.37774773203070483
Tennessee,47049,Fentress County,7403,1210,8687,6193,0.8521929319673075,0.13928859214918846,0.7129043398181191
Tennessee,47051,Franklin County,13977,4863,19146,9114,0.7300219366969602,0.25399561266060794,0.4760263240363523
Tennessee,47053,Gibson County,16245,5764,22336,10481,0.727301217765043,0.2580587392550143,0.46924247851002865
Tennessee,47055,Giles County,9783,3298,13202,6485,0.7410240872595061,0.24981063475231025,0.49121345250719584
Tennessee,47057,Grainger County,8559,1463,10123,7096,0.8455003457473081,0.14452237479008198,0.7009779709572261
Tennessee,47059,Greene County,22185,5183,28057,17002,0.7907117653348541,0.18473108315215453,0.6059806821826996
Tennessee,47061,Grundy County,4795,985,5844,3810,0.8204996577686516,0.16854893908281998,0.6519507186858317
Tennessee,47063,Hamblen County,18789,5497,24625,13292,0.763005076142132,0.2232284263959391,0.5397766497461929
Tennessee,47065,Hamilton County,91991,75360,170735,16631,0.5387940375435617,0.44138577327437256,0.09740826426918914
Tennessee,47067,Hancock County,2372,362,2744,2010,0.8644314868804664,0.13192419825072887,0.7325072886297376
Tennessee,47069,Hardeman County,5760,4180,10058,1580,0.5726784649035593,0.41558958043348576,0.15708888447007358
Tennessee,47071,Hardin County,9556,1774,11534,7782,0.82850702271545,0.15380613837350443,0.6747008843419455
Tennessee,47073,Hawkins County,20372,4069,24776,16303,0.8222473361317404,0.16423151436874395,0.6580158217629964
Tennessee,47075,Haywood County,3338,4000,7420,-662,0.44986522911051213,0.5390835579514824,-0.0892183288409703
Tennessee,47077,Henderson County,9797,2092,12020,7705,0.8150582362728785,0.1740432612312812,0.6410149750415973
Tennessee,47079,Henry County,11230,3547,15034,7683,0.7469735266728749,0.23593188772116536,0.5110416389517095
Tennessee,47081,Hickman County,7577,2130,9832,5447,0.7706468673718471,0.21663954434499594,0.5540073230268512
Tennessee,47083,Houston County,2715,869,3681,1846,0.7375713121434393,0.2360771529475686,0.5014941591958707
Tennessee,47085,Humphreys County,6116,2017,8232,4099,0.7429543245869776,0.24501943634596696,0.4979348882410107
Tennessee,47087,Jackson County,4106,1133,5308,2973,0.7735493594574228,0.2134513941220799,0.5600979653353428
Tennessee,47089,Jefferson County,18609,4645,23562,13964,0.7897886427298192,0.1971394618453442,0.5926491808844749
Tennessee,47091,Johnson County,6466,1242,7793,5224,0.829718978570512,0.15937379699730528,0.6703451815732068
Tennessee,47093,Knox County,124339,91097,219869,33242,0.565514010615412,0.4143239838267332,0.15119002678867877
Tennessee,47095,Lake County,1492,526,2034,966,0.7335299901671584,0.2586037364798427,0.47492625368731567
Tennessee,47097,Lauderdale County,5672,3193,8963,2479,0.6328238313064822,0.3562423295771505,0.2765815017293317
Tennessee,47099,Lawrence County,15334,3195,18718,12139,0.8192114542151939,0.17069131317448447,0.6485201410407094
Tennessee,47101,Lewis County,4473,1068,5604,3405,0.7981798715203426,0.1905781584582441,0.6076017130620985
Tennessee,47103,Lincoln County,12258,2909,15575,9349,0.7870304975922954,0.1867736757624398,0.6002568218298556
Tennessee,47105,Loudon County,21684,6933,29375,14751,0.7381787234042553,0.23601702127659574,0.5021617021276595
Tennessee,47107,McMinn County,18175,4357,22815,13818,0.7966250273942581,0.19097085250931406,0.605654174884944
Tennessee,47109,McNairy County,9085,1943,11267,7142,0.8063370906186208,0.17245051921540783,0.6338865714032129
Tennessee,47111,Macon County,8095,1307,9486,6788,0.8533628505165507,0.13778199451823742,0.7155808559983132
Tennessee,47113,Madison County,23922,18309,42847,5613,0.558312133871683,0.42731113030083784,0.13100100357084515
Tennessee,47115,Marion County,9873,3165,13204,6708,0.7477279612238715,0.23970009088155106,0.5080278703423204
Tennessee,47117,Marshall County,11029,3603,14862,7426,0.7420939308303055,0.24243035930561163,0.4996635715246939
Tennessee,47119,Maury County,31408,14386,46670,17022,0.6729805013927577,0.3082494107563745,0.36473109063638315
Tennessee,47121,Meigs County,4464,1008,5529,3456,0.8073792729245794,0.18231144872490504,0.6250678241996744
Tennessee,47123,Monroe County,16742,3760,20749,12982,0.8068822593859946,0.18121355246035953,0.625668706925635
Tennessee,47125,Montgomery County,42156,32426,76678,9730,0.5497795977985863,0.42288531260596257,0.12689428519262375
Tennessee,47127,Moore County,2888,573,3539,2315,0.8160497315625883,0.16191014410850524,0.6541395874540831
Tennessee,47129,Morgan County,6926,1161,8218,5765,0.8427841323923095,0.1412752494524215,0.701508882939888
Tennessee,47131,Obion County,10790,2589,13521,8201,0.7980178980844612,0.19147992012425116,0.60653797796021
Tennessee,47133,Overton County,7911,2028,10025,5883,0.7891271820448877,0.20229426433915212,0.5868329177057356
Tennessee,47135,Perry County,2775,615,3428,2160,0.80950991831972,0.1794049008168028,0.6301050175029171
Tennessee,47137,Pickett County,2373,524,2922,1849,0.8121149897330595,0.17932922655715264,0.6327857631759068
Tennessee,47139,Polk County,6792,1492,8360,5300,0.8124401913875599,0.1784688995215311,0.6339712918660287
Tennessee,47141,Putnam County,23694,9154,33481,14540,0.707684955646486,0.2734087990203399,0.43427615662614616
Tennessee,47143,Rhea County,11031,2363,13608,8668,0.810626102292769,0.17364785420340975,0.6369782480893592
Tennessee,47145,Roane County,19195,6034,25914,13161,0.7407193023076329,0.23284710967044842,0.5078721926371845
Tennessee,47147,Robertson County,24535,8690,33712,15845,0.727782392026578,0.2577717133364974,0.4700106786900806
Tennessee,47149,Rutherford County,81344,59177,143888,22167,0.5653285889024797,0.4112712665406427,0.154057322361837
Tennessee,47151,Scott County,8004,986,9052,7018,0.8842244807777286,0.10892620415377817,0.7752982766239505
Tennessee,47153,Sequatchie County,5846,1295,7239,4551,0.8075701063682829,0.17889211217018924,0.6286779941980936
Tennessee,47155,Sevier County,33742,8695,43574,25047,0.7743608573920228,0.1995456005875063,0.5748152568045164
Tennessee,47157,Shelby County,129543,245208,381858,-115665,0.33924390742108324,0.6421444620775262,-0.30290055465644294
Tennessee,47159,Smith County,7124,1798,9035,5326,0.7884892086330936,0.1990038738240177,0.5894853348090758
Tennessee,47161,Stewart County,4942,1230,6283,3712,0.7865669266274072,0.19576635365271366,0.5908005729746936
Tennessee,47163,Sullivan County,55774,17226,74206,38548,0.7516103819098187,0.23213756300029648,0.5194728189095221
Tennessee,47165,Sumner County,63404,27630,92529,35774,0.6852338185866053,0.2986090847193853,0.38662473386721996
Tennessee,47167,Tipton County,20063,6832,27291,13231,0.7351507823091862,0.25033893957715,0.4848118427320362
Tennessee,47169,Trousdale County,2930,1011,3991,1919,0.7341518416436983,0.2533199699323478,0.4808318717113505
Tennessee,47171,Unicoi County,6593,1610,8294,4983,0.794911984567157,0.19411622859898722,0.6007957559681697
Tennessee,47173,Union County,6777,1248,8096,5529,0.8370800395256917,0.1541501976284585,0.6829298418972332
Tennessee,47175,Van Buren County,2338,544,2917,1794,0.8015083990401097,0.18649297223174494,0.6150154268083647
Tennessee,47177,Warren County,12323,4126,16692,8197,0.7382578480709322,0.24718427989456027,0.49107356817637193
Tennessee,47179,Washington County,40120,18214,59474,21906,0.674580488953156,0.3062514712311262,0.3683290177220298
Tennessee,47181,Wayne County,5795,820,6667,4975,0.8692065396730163,0.12299385030748462,0.7462126893655316
Tennessee,47183,Weakley County,10382,3011,13710,7371,0.7572574762946754,0.21962071480671044,0.537636761487965
Tennessee,47185,White County,9587,2134,11867,7453,0.8078705654335553,0.1798264093705233,0.628044156063032
Tennessee,47187,Williamson County,86469,50161,139640,36308,0.6192280148954454,0.3592165568604984,0.260011458034947
Tennessee,47189,Wilson County,50149,22197,74096,27952,0.6768111638954869,0.2995708270351976,0.3772403368602893
Texas,48001,Anderson County,15062,3934,19155,11128,0.786322109109893,0.20537718611328634,0.5809449229966066
Texas,48003,Andrews County,4937,849,5856,4088,0.8430669398907104,0.1449795081967213,0.698087431693989
Texas,48005,Angelina County,25070,9136,34628,15934,0.7239805937391706,0.26383273651380384,0.4601478572253667
Texas,48007,Aransas County,9210,2896,12241,6314,0.7523895106608938,0.2365819785965199,0.5158075320643739
Texas,48009,Archer County,4300,446,4796,3854,0.896580483736447,0.09299416180150125,0.8035863219349458
Texas,48011,Armstrong County,1035,75,1112,960,0.9307553956834532,0.06744604316546762,0.8633093525179856
Texas,48013,Atascosa County,12020,5865,18085,6155,0.6646392037600222,0.3243019076582803,0.34033729610174185
Texas,48015,Austin County,11282,2931,14368,8351,0.78521714922049,0.20399498886414255,0.5812221603563474
Texas,48017,Bailey County,1430,407,1854,1023,0.7713052858683926,0.21952535059331177,0.5517799352750808
Texas,48019,Bandera County,10050,2503,12703,7547,0.7911516964496575,0.19704006927497442,0.5941116271746831
Texas,48021,Bastrop County,20486,15452,36709,5034,0.5580647797542837,0.42093219646408236,0.13713258329020134
Texas,48023,Baylor County,1478,179,1680,1299,0.8797619047619047,0.10654761904761904,0.7732142857142857
Texas,48025,Bee County,5999,3280,9405,2719,0.6378522062732589,0.3487506645401382,0.2891015417331207
Texas,48027,Bell County,67113,56032,125867,11081,0.5332056853662993,0.4451683125839179,0.08803737278238138
Texas,48029,Bexar County,303871,440823,757667,-136952,0.4010614161630373,0.5818162860465086,-0.18075486988347128
Texas,48031,Blanco County,5429,1905,7419,3524,0.7317697802938401,0.25677315002021833,0.47499663027362177
Texas,48033,Borden County,395,16,412,379,0.9587378640776699,0.038834951456310676,0.9199029126213593
Texas,48035,Bosque County,7446,1552,9094,5894,0.8187816142511546,0.1706619749285243,0.6481196393226303
Texas,48037,Bowie County,27053,10692,38194,16361,0.7083049693669162,0.2799392574749961,0.42836571189192013
Texas,48039,Brazoria County,89939,61780,154037,28159,0.5838791978550608,0.40107246960145937,0.18280672825360145
Texas,48041,Brazos County,47456,35242,84753,12214,0.5599329817233608,0.4158200889644024,0.1441128927589584
Texas,48043,Brewster County,2451,2251,4805,200,0.5100936524453694,0.4684703433922997,0.04162330905306971
Texas,48045,Briscoe County,639,77,724,562,0.8825966850828729,0.106353591160221,0.7762430939226519
Texas,48047,Brooks County,998,1470,2484,-472,0.40177133655394526,0.5917874396135265,-0.19001610305958128
Texas,48049,Brown County,13681,2103,15940,11578,0.8582810539523212,0.13193224592220829,0.7263488080301129
Texas,48051,Burleson County,6740,1786,8604,4954,0.7833565783356579,0.20757787075778708,0.5757787075778708
Texas,48053,Burnet County,18721,5615,24646,13106,0.7595958776272012,0.2278260163921123,0.5317698612350888
Texas,48055,Caldwell County,7975,6536,14775,1439,0.5397631133671743,0.44236886632825717,0.09739424703891714
Texas,48057,Calhoun County,5640,2146,7853,3494,0.7181968674391952,0.2732713612632115,0.4449255061759837
Texas,48059,Callahan County,6006,734,6826,5272,0.8798710811602696,0.10753003222970993,0.7723410489305597
Texas,48061,Cameron County,48834,63732,113789,-14898,0.4291627485960857,0.5600892880682667,-0.13092653947218102
Texas,48063,Camp County,3626,1392,5057,2234,0.717025904686573,0.2752620130512161,0.4417638916353569
Texas,48065,Carson County,2747,289,3081,2458,0.8915936384290815,0.09380071405387862,0.7977929243752029
Texas,48067,Cass County,10979,2777,13856,8202,0.7923643187066974,0.20041859122401848,0.5919457274826789
Texas,48069,Castro County,1601,466,2082,1135,0.7689721421709894,0.22382324687800192,0.5451488952929875
Texas,48071,Chambers County,17343,3997,21641,13346,0.801395499283767,0.18469571646411903,0.6166997828196479
Texas,48073,Cherokee County,15065,4196,19457,10869,0.7742714704219561,0.21565503417793083,0.5586164362440252
Texas,48075,Childress County,1928,305,2259,1623,0.8534749889331562,0.13501549358123063,0.7184594953519255
Texas,48077,Clay County,5064,614,5736,4450,0.8828451882845189,0.10704323570432357,0.7758019525801952
Texas,48079,Cochran County,806,176,996,630,0.8092369477911646,0.17670682730923695,0.6325301204819277
Texas,48081,Coke County,1565,215,1794,1350,0.8723522853957637,0.11984392419175027,0.7525083612040134
Texas,48083,Coleman County,3640,451,4128,3189,0.8817829457364341,0.10925387596899225,0.7725290697674418
Texas,48085,Collin County,250194,227868,486917,22326,0.5138329530494931,0.4679811959738518,0.045851757075641264
Texas,48087,Collingsworth County,1048,155,1218,893,0.8604269293924466,0.1272577996715928,0.7331691297208538
Texas,48089,Colorado County,7440,2403,9912,5037,0.7506053268765133,0.24243341404358354,0.5081719128329297
Texas,48091,Comal County,62260,24369,87942,37891,0.7079666143594642,0.2771030906733984,0.4308635236860658
Texas,48093,Comanche County,5177,852,6084,4325,0.8509204470742933,0.14003944773175542,0.7108809993425378
Texas,48095,Concho County,1058,197,1268,861,0.8343848580441641,0.1553627760252366,0.6790220820189274
Texas,48097,Cooke County,15579,3205,18997,12374,0.8200768542401432,0.1687108490814339,0.6513660051587093
Texas,48099,Coryell County,15397,7542,23425,7855,0.6572892209178228,0.32196371398078977,0.33532550693703306
Texas,48101,Cottle County,543,113,665,430,0.8165413533834587,0.1699248120300752,0.6466165413533835
Texas,48103,Crane County,1247,241,1503,1006,0.8296739853626082,0.1603459747172322,0.669328010645376
Texas,48105,Crockett County,1219,344,1573,875,0.7749523204068659,0.21869040050858232,0.5562619198982836
Texas,48107,Crosby County,1396,527,1953,869,0.7147977470558116,0.2698412698412698,0.44495647721454173
Texas,48109,Culberson County,415,438,864,-23,0.48032407407407407,0.5069444444444444,-0.02662037037037035
Texas,48111,Dallam County,1386,196,1605,1190,0.8635514018691589,0.1221183800623053,0.7414330218068537
Texas,48113,Dallas County,306572,597407,919929,-290835,0.3332561534640173,0.6494055519502049,-0.31614939848618756
Texas,48115,Dawson County,2951,808,3789,2143,0.7788334652942729,0.21324887833201372,0.5655845869622591
Texas,48117,Deaf Smith County,3293,1263,4608,2030,0.7146267361111112,0.2740885416666667,0.4405381944444445
Texas,48119,Delta County,2157,403,2587,1754,0.8337843061461152,0.15577889447236182,0.6780054116737534
Texas,48121,Denton County,221829,188023,416610,33806,0.5324620148340174,0.4513165790547514,0.08114543577926603
Texas,48123,DeWitt County,6567,1494,8118,5073,0.8089430894308943,0.18403547671840353,0.6249076127124908
Texas,48125,Dickens County,850,130,985,720,0.8629441624365483,0.1319796954314721,0.7309644670050761
Texas,48127,Dimmit County,1384,2264,3666,-880,0.37752318603382434,0.6175668303327878,-0.24004364429896347
Texas,48129,Donley County,1438,198,1648,1240,0.8725728155339806,0.12014563106796117,0.7524271844660194
Texas,48131,Duval County,2442,2573,5050,-131,0.48356435643564355,0.5095049504950495,-0.025940594059405964
Texas,48133,Eastland County,7216,982,8271,6234,0.8724458952968203,0.11872808608390763,0.7537178092129126
Texas,48135,Ector County,32586,11310,44417,21276,0.7336380214782628,0.25463223540536284,0.4790057860729
Texas,48137,Edwards County,893,166,1064,727,0.8392857142857143,0.15601503759398497,0.6832706766917294
Texas,48139,Ellis County,56651,27513,85566,29138,0.6620737208704391,0.3215412663908562,0.34053245447958297
Texas,48141,El Paso County,81235,168801,254576,-87566,0.3190992080950286,0.6630672176481679,-0.3439680095531393
Texas,48143,Erath County,13669,2914,16837,10755,0.811842964898735,0.17307121221120153,0.6387717526875334
Texas,48145,Falls County,4177,1899,6133,2278,0.681069623349095,0.3096363932822436,0.3714332300668514
Texas,48147,Fannin County,12150,2638,14969,9512,0.8116774667646469,0.17623087714610194,0.6354465896185449
Texas,48149,Fayette County,10163,2650,12924,7513,0.7863664500154751,0.20504487774682761,0.5813215722686476
Texas,48151,Fisher County,1448,352,1826,1096,0.7929901423877328,0.1927710843373494,0.6002190580503834
Texas,48153,Floyd County,1581,437,2035,1144,0.7769041769041769,0.21474201474201474,0.5621621621621622
Texas,48155,Foard County,445,99,551,346,0.8076225045372051,0.17967332123411978,0.6279491833030852
Texas,48157,Fort Bend County,157595,195191,357833,-37596,0.4404149421657589,0.5454807130700634,-0.10506577090430452
Texas,48159,Franklin County,4153,803,5000,3350,0.8306,0.1606,0.67
Texas,48161,Freestone County,6966,1629,8678,5337,0.8027195206268726,0.18771606360912652,0.6150034570177461
Texas,48163,Frio County,2812,2421,5264,391,0.53419452887538,0.4599164133738602,0.0742781155015198
Texas,48165,Gaines County,5323,572,5960,4751,0.8931208053691275,0.0959731543624161,0.7971476510067115
Texas,48167,Galveston County,93306,58247,153843,35059,0.6065014332793822,0.3786132615718622,0.22788817170752002
Texas,48169,Garza County,1411,231,1651,1180,0.854633555420957,0.1399152029073289,0.714718352513628
Texas,48171,Gillespie County,12495,3163,15817,9332,0.7899728140608206,0.19997471075425174,0.5899981033065689
Texas,48173,Glasscock County,611,39,653,572,0.9356814701378254,0.05972434915773354,0.8759571209800919
Texas,48175,Goliad County,3081,872,3978,2209,0.7745098039215687,0.21920563097033685,0.5553041729512318
Texas,48177,Gonzales County,5568,1894,7534,3674,0.7390496416246349,0.25139368197504647,0.48765595964958847
Texas,48179,Gray County,6812,820,7745,5992,0.8795351839896708,0.10587475790832795,0.7736604260813429
Texas,48181,Grayson County,43776,14223,58760,29553,0.7449965963240299,0.24205241660993873,0.5029441797140912
Texas,48183,Gregg County,32352,14657,47700,17695,0.6782389937106919,0.30727463312368974,0.3709643605870021
Texas,48185,Grimes County,9419,2831,12398,6588,0.759719309566059,0.22834328117438296,0.5313760283916761
Texas,48187,Guadalupe County,47423,28706,77382,18717,0.6128427799746711,0.37096482386084617,0.2418779561138249
Texas,48189,Hale County,7162,2271,9560,4891,0.749163179916318,0.23755230125523014,0.5116108786610878
Texas,48191,Hall County,992,167,1165,825,0.8515021459227468,0.14334763948497853,0.7081545064377682
Texas,48193,Hamilton County,3613,641,4347,2972,0.8311479181044399,0.1474580170232344,0.6836899010812054
Texas,48195,Hansford County,1848,166,2046,1682,0.9032258064516129,0.08113391984359726,0.8220918866080156
Texas,48197,Hardeman County,1330,241,1580,1089,0.8417721518987342,0.15253164556962026,0.6892405063291139
Texas,48199,Hardin County,23806,3449,27555,20357,0.8639448375975322,0.12516784612592996,0.7387769914716023
Texas,48201,Harris County,699822,911974,1633671,-212152,0.42837388923473574,0.5582360218183465,-0.1298621325836108
Texas,48203,Harrison County,21318,7812,29462,13506,0.7235761319666011,0.2651551150634716,0.4584210169031295
Texas,48205,Hartley County,1866,195,2076,1671,0.8988439306358381,0.09393063583815028,0.8049132947976878
Texas,48207,Haskell County,1837,353,2211,1484,0.8308457711442786,0.15965626413387607,0.6711895070104026
Texas,48209,Hays County,47427,59213,108822,-11786,0.4358218007388212,0.5441271066512287,-0.10830530591240745
Texas,48211,Hemphill County,1486,206,1720,1280,0.8639534883720931,0.11976744186046512,0.7441860465116279
Texas,48213,Henderson County,28816,7048,36197,21768,0.7960880735972594,0.1947122689725668,0.6013758046246926
Texas,48215,Hidalgo County,89991,127507,219939,-37516,0.40916344986564457,0.5797380182687017,-0.17057456840305718
Texas,48217,Hill County,11869,2829,14843,9040,0.7996361921444451,0.1905948932156572,0.6090412989287879
Texas,48219,Hockley County,6534,1481,8091,5053,0.8075639599555061,0.18304288715857125,0.6245210727969348
Texas,48221,Hood County,26487,5641,32580,20846,0.8129834254143646,0.17314303253529773,0.6398403928790669
Texas,48223,Hopkins County,12713,3043,15932,9670,0.7979538036655787,0.1909992467988953,0.6069545568666834
Texas,48225,Houston County,7050,2312,9426,4738,0.7479312539783577,0.24527901548907277,0.5026522384892849
Texas,48227,Howard County,7899,2017,10043,5882,0.7865179727173155,0.20083640346510007,0.5856815692522155
Texas,48229,Hudspeth County,771,371,1157,400,0.6663785652549697,0.320656871218669,0.34572169403630076
Texas,48231,Hunt County,29135,8879,38517,20256,0.7564192434509437,0.23052158787029103,0.5258976555806527
Texas,48233,Hutchinson County,7659,957,8741,6702,0.876215535979865,0.10948404072760554,0.7667314952522595
Texas,48235,Irion County,759,120,889,639,0.8537682789651294,0.13498312710911137,0.718785151856018
Texas,48237,Jack County,3415,331,3779,3084,0.9036782217517861,0.08758930934109553,0.8160889124106906
Texas,48239,Jackson County,5116,1018,6210,4098,0.8238325281803542,0.16392914653784219,0.659903381642512
Texas,48241,Jasper County,12453,2906,15469,9547,0.8050294136660417,0.18785959014803802,0.6171698235180038
Texas,48243,Jeff Davis County,783,501,1304,282,0.6004601226993865,0.38420245398773006,0.21625766871165647
Texas,48245,Jefferson County,47535,46022,94665,1513,0.5021391221676438,0.4861564464163102,0.015982675751333608
Texas,48247,Jim Hogg County,831,1197,2034,-366,0.4085545722713864,0.588495575221239,-0.17994100294985255
Texas,48249,Jim Wells County,7389,6025,13507,1364,0.5470496779447693,0.4460650033316058,0.10098467461316352
Texas,48251,Johnson County,54523,16418,71928,38105,0.7580219107996886,0.22825603381158938,0.5297658769880993
Texas,48253,Jones County,5621,989,6691,4632,0.8400836945150202,0.14781049170527574,0.6922732028097445
Texas,48255,Karnes County,3959,1220,5229,2739,0.7571237330273475,0.23331420921782367,0.5238095238095238
Texas,48257,Kaufman County,37474,18290,56435,19184,0.6640205546203597,0.3240896606715691,0.3399308939487906
Texas,48259,Kendall County,20064,6008,26419,14056,0.759453423672357,0.22741208978386768,0.5320413338884893
Texas,48261,Kenedy County,127,65,194,62,0.654639175257732,0.33505154639175255,0.3195876288659794
Texas,48263,Kent County,411,47,462,364,0.8896103896103896,0.10173160173160173,0.7878787878787878
Texas,48265,Kerr County,20858,6510,27738,14348,0.751964813613094,0.2346960847934242,0.5172687288196698
Texas,48267,Kimble County,1987,284,2292,1703,0.8669284467713787,0.12390924956369982,0.7430191972076788
Texas,48269,King County,151,8,159,143,0.949685534591195,0.050314465408805034,0.89937106918239
Texas,48271,Kinney County,1144,446,1603,698,0.7136618839675608,0.27822832189644414,0.43543356207111666
Texas,48273,Kleberg County,5557,5359,11041,198,0.5033058599764514,0.48537270174803004,0.017933158228421342
Texas,48275,Knox County,1180,265,1456,915,0.8104395604395604,0.1820054945054945,0.6284340659340659
Texas,48277,Lamar County,16698,4420,21338,12278,0.7825475677195614,0.20714218764645234,0.575405380073109
Texas,48279,Lamb County,3513,835,4394,2678,0.7994993172507966,0.19003186162949476,0.6094674556213018
Texas,48281,Lampasas County,8070,2134,10373,5936,0.7779812975995373,0.20572640509013787,0.5722548925093994
Texas,48283,La Salle County,1335,1052,2406,283,0.5548628428927681,0.4372402327514547,0.11762261014131342
Texas,48285,Lavaca County,8802,1333,10195,7469,0.8633643943109367,0.13075036782736635,0.7326140264835703
Texas,48287,Lee County,6248,1745,8075,4503,0.7737461300309597,0.21609907120743035,0.5576470588235294
Texas,48289,Leon County,7522,1072,8672,6450,0.8673892988929889,0.12361623616236163,0.7437730627306273
Texas,48291,Liberty County,23288,5779,29314,17509,0.7944326942757727,0.1971412976734666,0.5972913966023061
Texas,48293,Limestone County,6786,2213,9092,4573,0.7463704355477343,0.2434007919049714,0.5029696436427629
Texas,48295,Lipscomb County,1203,131,1351,1072,0.8904515173945226,0.09696521095484827,0.7934863064396743
Texas,48297,Live Oak County,4198,819,5053,3379,0.830793587967544,0.16208193152582623,0.6687116564417177
Texas,48299,Llano County,9996,3167,13278,6829,0.7528242205151379,0.23851483657177286,0.514309383943365
Texas,48301,Loving County,60,4,66,56,0.9090909090909091,0.06060606060606061,0.8484848484848484
Texas,48303,Lubbock County,78560,39757,120204,38803,0.6535556221090812,0.3307460650227946,0.32280955708628667
Texas,48305,Lynn County,1853,428,2293,1425,0.8081116441343218,0.18665503706934147,0.6214566070649803
Texas,48307,McCulloch County,2898,490,3430,2408,0.8448979591836735,0.14285714285714285,0.7020408163265306
Texas,48309,McLennan County,59432,36550,97617,22882,0.6088283803026112,0.37442248788633126,0.23440589241627996
Texas,48311,McMullen County,460,53,516,407,0.8914728682170543,0.10271317829457365,0.7887596899224807
Texas,48313,Madison County,4165,1084,5289,3081,0.7874834562299111,0.20495367744375118,0.58252977878616
Texas,48315,Marion County,3459,1331,4844,2128,0.7140792733278283,0.27477291494632533,0.43930635838150295
Texas,48317,Martin County,1857,288,2160,1569,0.8597222222222223,0.13333333333333333,0.726388888888889
Texas,48319,Mason County,2108,566,2700,1542,0.7807407407407407,0.20962962962962964,0.5711111111111111
Texas,48321,Matagorda County,9836,3726,13710,6110,0.7174325309992706,0.27177242888402625,0.44566010211524437
Texas,48323,Maverick County,6881,8324,15338,-1443,0.4486243317251271,0.5427043943147738,-0.09408006258964668
Texas,48325,Medina County,15599,6731,22568,8868,0.6911999291031549,0.29825416518964903,0.39294576391350583
Texas,48327,Menard County,819,196,1023,623,0.8005865102639296,0.19159335288367546,0.6089931573802541
Texas,48329,Midland County,45463,12258,58752,33205,0.7738119553376906,0.20863970588235295,0.5651722494553377
Texas,48331,Milam County,7950,2475,10523,5475,0.7554879787132947,0.23519908771262948,0.5202888910006651
Texas,48333,Mills County,2214,271,2502,1943,0.8848920863309353,0.10831334932054357,0.7765787370103917
Texas,48335,Mitchell County,2169,397,2579,1772,0.8410236525785189,0.15393563396665375,0.6870880186118651
Texas,48337,Montague County,8613,1097,9812,7516,0.8778026905829597,0.11180187525479006,0.7660008153281697
Texas,48339,Montgomery County,193224,74255,271175,118969,0.7125435604314557,0.2738268645708491,0.43871669586060663
Texas,48341,Moore County,4356,1059,5502,3297,0.7917121046892039,0.19247546346782987,0.5992366412213741
Texas,48343,Morris County,3841,1664,5548,2177,0.6923215573179524,0.2999279019466474,0.392393655371305
Texas,48345,Motley County,604,46,652,558,0.9263803680981595,0.0705521472392638,0.8558282208588956
Texas,48347,Nacogdoches County,17359,8989,26755,8370,0.6488133059241263,0.33597458418987103,0.3128387217342553
Texas,48349,Navarro County,13787,5097,19105,8690,0.7216435488092122,0.26678879874378436,0.45485475006542786
Texas,48351,Newton County,4882,1175,6096,3707,0.8008530183727034,0.192749343832021,0.6081036745406824
Texas,48353,Nolan County,4127,1161,5352,2966,0.7711136023916293,0.21692825112107622,0.554185351270553
Texas,48355,Nueces County,64467,60749,126984,3718,0.5076781326781327,0.4783988533988534,0.029279279279279258
Texas,48357,Ochiltree County,2811,302,3155,2509,0.8909667194928684,0.09572107765451664,0.7952456418383518
Texas,48359,Oldham County,917,81,1009,836,0.908820614469772,0.0802775024777007,0.8285431119920713
Texas,48361,Orange County,29170,6354,35974,22816,0.8108634013454161,0.17662756435203203,0.634235836993384
Texas,48363,Palo Pinto County,10170,2177,12478,7993,0.8150344606507454,0.17446706202917134,0.6405673986215741
Texas,48365,Panola County,9322,2057,11452,7265,0.8140062871114215,0.1796192804750262,0.6343870066363954
Texas,48367,Parker County,61584,12789,75434,48795,0.8163957896969536,0.1695389346978816,0.646856854999072
Texas,48369,Parmer County,2133,488,2648,1645,0.8055135951661632,0.18429003021148035,0.6212235649546828
Texas,48371,Pecos County,3213,1378,4668,1835,0.6883033419023136,0.2952013710368466,0.39310197086546694
Texas,48373,Polk County,18496,5353,24072,13143,0.768361581920904,0.222374543037554,0.54598703888335
Texas,48375,Potter County,22732,9867,33242,12865,0.6838337043499187,0.29682329583057576,0.387010408519343
Texas,48377,Presidio County,721,1463,2217,-742,0.3252142534957149,0.6599007668019846,-0.3346865133062697
Texas,48379,Rains County,5147,841,6044,4306,0.8515883520847121,0.13914626075446723,0.7124420913302448
Texas,48381,Randall County,57695,11414,69973,46281,0.8245323196089921,0.16312006059480086,0.6614122590141912
Texas,48383,Reagan County,942,172,1124,770,0.8380782918149466,0.15302491103202848,0.6850533807829182
Texas,48385,Real County,1643,320,1982,1323,0.8289606458123108,0.16145307769929365,0.6675075681130171
Texas,48387,Red River County,4513,1244,5800,3269,0.7781034482758621,0.21448275862068966,0.5636206896551724
Texas,48389,Reeves County,2249,1394,3683,855,0.6106434971490633,0.3784957914743416,0.2321477056747217
Texas,48391,Refugio County,2210,1108,3366,1102,0.6565656565656566,0.32917409387997626,0.3273915626856803
Texas,48393,Roberts County,529,17,550,512,0.9618181818181818,0.03090909090909091,0.9309090909090909
Texas,48395,Robertson County,5631,2359,8080,3272,0.6969059405940594,0.29195544554455444,0.404950495049505
Texas,48397,Rockwall County,38842,18149,57792,20693,0.6720999446290143,0.31404000553709854,0.3580599390919158
Texas,48399,Runnels County,3682,531,4262,3151,0.8639136555607696,0.12458939465039888,0.7393242609103707
Texas,48401,Rusk County,16511,4624,21367,11887,0.7727336547011747,0.21640848036692095,0.5563251743342538
Texas,48403,Sabine County,4767,662,5462,4105,0.8727572317832296,0.12120102526547052,0.7515562065177591
Texas,48405,San Augustine County,3005,979,3998,2026,0.7516258129064533,0.24487243621810906,0.5067533766883442
Texas,48407,San Jacinto County,10154,2332,12628,7822,0.8040861577446944,0.18466898954703834,0.619417168197656
Texas,48409,San Patricio County,16495,8971,25850,7524,0.6381044487427466,0.3470406189555126,0.29106382978723405
Texas,48411,San Saba County,2308,287,2602,2021,0.8870099923136049,0.11029976940814758,0.7767102229054573
Texas,48413,Schleicher County,939,211,1158,728,0.810880829015544,0.18221070811744386,0.6286701208981001
Texas,48415,Scurry County,4978,818,5865,4160,0.848763853367434,0.13947144075021312,0.7092924126172209
Texas,48417,Shackelford County,1484,130,1628,1354,0.9115479115479116,0.07985257985257985,0.8316953316953317
Texas,48419,Shelby County,7962,2058,10063,5904,0.7912153433369771,0.2045115770644937,0.5867037662724834
Texas,48421,Sherman County,885,91,990,794,0.8939393939393939,0.09191919191919191,0.802020202020202
Texas,48423,Smith County,68546,29343,99521,39203,0.6887591563589595,0.29484229459109135,0.3939168617678681
Texas,48425,Somervell County,4099,768,4940,3331,0.8297570850202429,0.15546558704453442,0.6742914979757085
Texas,48427,Starr County,8224,9099,17478,-875,0.47053438608536446,0.5205973223480947,-0.050062936262730284
Texas,48429,Stephens County,3385,396,3799,2989,0.8910239536720189,0.10423795735719926,0.7867859963148196
Texas,48431,Sterling County,584,51,639,533,0.9139280125195618,0.07981220657276995,0.8341158059467918
Texas,48433,Stonewall County,615,116,736,499,0.8355978260869565,0.15760869565217392,0.6779891304347826
Texas,48435,Sutton County,1222,322,1557,900,0.7848426461143224,0.20680796403339757,0.5780346820809248
Texas,48437,Swisher County,1842,478,2353,1364,0.782830429239269,0.20314492137696558,0.5796855078623034
Texas,48439,Tarrant County,407702,409067,830104,-1365,0.4911456877692434,0.4927900600406696,-0.0016443722714262199
Texas,48441,Taylor County,39439,14489,54924,24950,0.7180649624936276,0.2638008885004734,0.4542640739931542
Texas,48443,Terrell County,334,119,458,215,0.7292576419213974,0.259825327510917,0.4694323144104804
Texas,48445,Terry County,2809,757,3608,2052,0.7785476718403548,0.20981152993348115,0.5687361419068736
Texas,48447,Throckmorton County,806,82,899,724,0.896551724137931,0.09121245828698554,0.8053392658509455
Texas,48449,Titus County,7563,2852,10530,4711,0.7182336182336182,0.2708452041785375,0.4473884140550807
Texas,48451,Tom Green County,32129,12106,44891,20023,0.7157113898108752,0.26967543605622507,0.44603595375465016
Texas,48453,Travis County,159907,432062,605034,-272155,0.26429423800976476,0.7141119342053505,-0.4498176961955857
Texas,48455,Trinity County,5579,1323,6938,4256,0.8041222254251946,0.19068895935428076,0.6134332660709139
Texas,48457,Tyler County,8095,1390,9547,6705,0.8479103383261758,0.14559547501833037,0.7023148633078454
Texas,48459,Upshur County,15775,2869,18850,12906,0.8368700265251989,0.15220159151193635,0.6846684350132626
Texas,48461,Upton County,1176,169,1365,1007,0.8615384615384616,0.12380952380952381,0.7377289377289378
Texas,48463,Uvalde County,6160,4066,10323,2094,0.5967257580160806,0.3938777487164584,0.2028480092996222
Texas,48465,Val Verde County,7839,6401,14417,1438,0.5437330928764653,0.4439897343414025,0.09974335853506283
Texas,48467,Van Zandt County,22126,3419,25753,18707,0.8591620393740536,0.13276123170116103,0.7264008076728925
Texas,48469,Victoria County,23347,10371,34205,12976,0.6825610290893144,0.303201286361643,0.37935974272767137
Texas,48471,Walker County,15368,7875,23641,7493,0.6500571041834102,0.3331077365593672,0.316949367624043
Texas,48473,Waller County,14206,8130,22617,6076,0.6281115974709289,0.35946411990980237,0.26864747756112656
Texas,48475,Ward County,3238,761,4034,2477,0.8026772434308379,0.1886465047099653,0.6140307387208725
Texas,48477,Washington County,12949,4254,17410,8695,0.7437679494543366,0.2443423319931074,0.49942561746122915
Texas,48479,Webb County,25898,41820,68439,-15922,0.3784099709230117,0.6110551001621882,-0.23264512923917652
Texas,48481,Wharton County,11892,4671,16709,7221,0.7117122508827578,0.27954994314441317,0.43216230773834463
Texas,48483,Wheeler County,2158,168,2336,1990,0.9238013698630136,0.07191780821917808,0.8518835616438356
Texas,48485,Wichita County,31930,13024,45753,18906,0.6978777347933469,0.28465892946910587,0.41321880532424105
Texas,48487,Wilbarger County,3520,954,4518,2566,0.7791057990261178,0.21115537848605578,0.567950420540062
Texas,48489,Willacy County,2437,3097,5575,-660,0.43713004484304935,0.5555156950672646,-0.11838565022421527
Texas,48491,Williamson County,138649,142457,287696,-3808,0.4819288415549747,0.4951650353150548,-0.013236193760080117
Texas,48493,Wilson County,18457,6350,25006,12107,0.7381028553147244,0.25393905462688954,0.4841638006878349
Texas,48495,Winkler County,1753,358,2126,1395,0.8245531514581373,0.16839134524929444,0.6561618062088429
Texas,48497,Wise County,26986,4953,32297,22033,0.8355574821190823,0.1533578970182989,0.6821995851007834
Texas,48499,Wood County,18962,3487,22665,15475,0.8366203397308626,0.15384954776086476,0.6827707919699978
Texas,48501,Yoakum County,2172,419,2633,1753,0.8249145461450816,0.1591340676034941,0.6657804785415875
Texas,48503,Young County,7112,1036,8242,6076,0.8628973550109197,0.12569764620237805,0.7371997088085416
Texas,48505,Zapata County,2032,1820,3867,212,0.5254719420739591,0.4706490819756918,0.05482286009826731
Texas,48507,Zavala County,1490,2864,4379,-1374,0.3402603334094542,0.6540306005937429,-0.31377026718428863
Utah,49001,Beaver County,2673,356,3076,2317,0.8689856957087126,0.11573472041612484,0.7532509752925878
Utah,49003,Box Elder County,20660,4280,26027,16380,0.793791063126753,0.16444461520728473,0.6293464479194683
Utah,49005,Cache County,34377,15246,52792,19131,0.6511782088195182,0.2887937566297924,0.36238445218972576
Utah,49007,Carbon County,6255,2306,8822,3949,0.709022897302199,0.2613919746089322,0.4476309226932668
Utah,49009,Daggett County,473,105,590,368,0.8016949152542373,0.17796610169491525,0.6237288135593221
Utah,49011,Davis County,89326,51697,147774,37629,0.6044771069335607,0.3498382665421522,0.2546388403914085
Utah,49013,Duchesne County,7445,830,8476,6615,0.8783624351109014,0.09792354884379424,0.7804388862671071
Utah,49015,Emery County,4166,566,4816,3600,0.8650332225913622,0.1175249169435216,0.7475083056478405
Utah,49017,Garfield County,2149,513,2722,1636,0.7894930198383542,0.1884643644379133,0.6010286554004409
Utah,49019,Grand County,2168,2733,5027,-565,0.4312711358663219,0.5436642132484584,-0.1123930773821365
Utah,49021,Iron County,18113,4673,23731,13440,0.7632632421726855,0.1969154270785049,0.5663478150941805
Utah,49023,Juab County,5069,638,5875,4431,0.8628085106382979,0.10859574468085106,0.7542127659574468
Utah,49025,Kane County,2777,1005,3869,1772,0.7177565262341691,0.25975704316360815,0.45799948307056093
Utah,49027,Millard County,4267,529,4887,3738,0.8731328013095969,0.1082463679148762,0.7648864333947207
Utah,49029,Morgan County,4957,1060,6254,3897,0.7926127278541734,0.1694915254237288,0.6231212024304446
Utah,49031,Piute County,773,86,871,687,0.8874856486796785,0.09873708381171067,0.7887485648679678
Utah,49033,Rich County,1118,178,1320,940,0.8469696969696969,0.13484848484848486,0.712121212121212
Utah,49035,Salt Lake County,162607,226446,404685,-63839,0.4018112853206815,0.5595611401460395,-0.15774985482535803
Utah,49037,San Juan County,2634,2451,5243,183,0.5023841312225825,0.4674804501239748,0.0349036810986077
Utah,49039,Sanpete County,9961,1724,12133,8237,0.8209840929695871,0.14209181570922277,0.6788922772603643
Utah,49041,Sevier County,8427,1032,9731,7395,0.8659952728393793,0.10605282088171822,0.7599424519576611
Utah,49043,Summit County,6122,11733,18130,-5611,0.3376723662437948,0.6471594043022615,-0.30948703805846667
Utah,49045,Tooele County,19531,8498,29770,11033,0.6560631508229762,0.28545515619751427,0.3706079946254619
Utah,49047,Uintah County,12777,1601,14796,11176,0.8635442011354421,0.10820492024871586,0.7553392808867262
Utah,49049,Utah County,173856,69386,259688,104470,0.6694802994362465,0.26718985859955025,0.4022904408366963
Utah,49051,Wasatch County,9953,5762,16456,4191,0.6048249878463782,0.35014584346135147,0.2546791443850267
Utah,49053,Washington County,65601,20065,88807,45536,0.7386917697929217,0.22593939666918147,0.5127523731237402
Utah,49055,Wayne County,1207,362,1596,845,0.756265664160401,0.22681704260651628,0.5294486215538847
Utah,49057,Weber County,64066,39652,108335,24414,0.5913693635482531,0.36601283057183737,0.22535653297641572
Vermont,50001,Addison County,6292,14964,22029,-8672,0.2856234963003314,0.679286395206319,-0.39366289890598755
Vermont,50003,Bennington County,7096,12591,20340,-5495,0.3488692232055064,0.6190265486725663,-0.27015732546705995
Vermont,50005,Caledonia County,6551,9010,16186,-2459,0.40473248486346225,0.5566538984307426,-0.1519214135672804
Vermont,50007,Chittenden County,19614,59573,81662,-39959,0.2401851534373393,0.729506992236291,-0.48932183879895175
Vermont,50009,Essex County,1773,1405,3288,368,0.5392335766423357,0.42731143552311435,0.11192214111922139
Vermont,50011,Franklin County,11267,13576,25820,-2309,0.43636715724244773,0.5257939581719597,-0.089426800929512
Vermont,50013,Grand Isle County,1810,2905,4863,-1095,0.3721982315443142,0.5973678799095209,-0.2251696483652067
Vermont,50015,Lamoille County,4163,10240,14951,-6077,0.27844291351749045,0.6849040197980069,-0.4064611062805164
Vermont,50017,Orange County,6178,10281,17101,-4103,0.361265423074674,0.6011929126951641,-0.23992748962049004
Vermont,50019,Orleans County,6512,7147,14103,-635,0.4617457278593207,0.5067716088775438,-0.04502588101822308
Vermont,50021,Rutland County,14652,18205,33946,-3553,0.4316267012313675,0.5362929358392742,-0.1046662346079067
Vermont,50023,Washington County,8925,25169,35304,-16244,0.25280421481985044,0.7129220484930886,-0.46011783367323816
Vermont,50025,Windham County,6308,18766,26078,-12458,0.2418897154689777,0.7196103995705192,-0.4777206841015415
Vermont,50027,Windsor County,9990,23399,34507,-13409,0.28950647694670645,0.6780942997073057,-0.3885878227605993
Virginia,51001,Accomack County,9172,7578,16959,1594,0.5408337755763901,0.44684238457456216,0.09399139100182796
Virginia,51003,Albemarle County,20711,42132,64209,-21421,0.3225560279711567,0.6561696958370322,-0.33361366786587554
Virginia,51005,Alleghany County,5859,2243,8191,3616,0.7152972774996947,0.27383713832254913,0.4414601391771456
Virginia,51007,Amelia County,5370,2390,7837,2980,0.6852111777465867,0.30496363404363913,0.38024754370294755
Virginia,51009,Amherst County,11053,5680,16985,5373,0.6507506623491316,0.3344127171033265,0.3163379452458051
Virginia,51011,Appomattox County,6702,2418,9268,4284,0.7231333621061717,0.26089771255934396,0.4622356495468278
Virginia,51013,Arlington County,22205,105167,129202,-82962,0.17186266466463368,0.8139734679029736,-0.64211080323834
Virginia,51015,Augusta County,30556,10748,41898,19808,0.7292949544130984,0.2565277578882047,0.47276719652489374
Virginia,51017,Bath County,1824,674,2513,1150,0.7258257063270991,0.2682053322721846,0.45762037405491446
Virginia,51019,Bedford County,35369,11986,48041,23383,0.7362253075498012,0.24949522283049894,0.48673008471930224
Virginia,51021,Bland County,2903,532,3475,2371,0.8353956834532374,0.1530935251798561,0.6823021582733814
Virginia,51023,Botetourt County,15033,5637,20924,9396,0.7184572739437965,0.2694035557254827,0.44905371821831386
Virginia,51025,Brunswick County,3343,4533,7915,-1190,0.42236260265319014,0.5727100442198357,-0.1503474415666456
Virginia,51027,Buchanan County,8311,1587,9953,6724,0.8350246156937606,0.15944941223751632,0.6755752034562443
Virginia,51029,Buckingham County,4544,3471,8108,1073,0.5604341391218549,0.4280957079427726,0.13233843117908234
Virginia,51031,Campbell County,21211,8041,29739,13170,0.7132385083560308,0.2703856888261206,0.4428528195299102
Virginia,51033,Caroline County,8109,7733,16097,376,0.50375846431012,0.48040007454805245,0.0233583897620675
Virginia,51035,Carroll County,12659,2842,15619,9817,0.8104872270952046,0.18195787182277995,0.6285293552724247
Virginia,51036,Charles City County,1761,2624,4439,-863,0.3967109709394008,0.5911241270556432,-0.19441315611624244
Virginia,51037,Charlotte County,3815,2317,6191,1498,0.6162170893232111,0.3742529478274915,0.24196414149571954
Virginia,51041,Chesterfield County,98541,111094,212576,-12553,0.463556563299714,0.522608384765919,-0.05905182146620497
Virginia,51043,Clarke County,5192,3920,9290,1272,0.5588805166846071,0.4219590958019376,0.13692142088266956
Virginia,51045,Craig County,2536,587,3163,1949,0.8017704710717674,0.18558330698703762,0.6161871640847297
Virginia,51047,Culpeper County,16013,10617,27117,5396,0.5905151749824833,0.3915256112401814,0.19898956374230187
Virginia,51049,Cumberland County,3019,2230,5302,789,0.569407770652584,0.42059600150886456,0.1488117691437194
Virginia,51051,Dickenson County,5746,1501,7299,4245,0.7872311275517194,0.20564460885052746,0.5815865187011919
Virginia,51053,Dinwiddie County,8695,6224,15063,2471,0.5772422492199429,0.41319790214432717,0.16404434707561577
Virginia,51057,Essex County,3075,3038,6171,37,0.49829849295089934,0.4923027062064495,0.005995786744449838
Virginia,51059,Fairfax County,162312,404886,578931,-242574,0.2803650175927701,0.6993683185042777,-0.4190033009115076
Virginia,51061,Fauquier County,25133,17362,43260,7771,0.5809754969949145,0.4013407304669441,0.1796347665279704
Virginia,51063,Floyd County,6189,2970,9329,3219,0.6634151570371959,0.3183620966877479,0.345053060349448
Virginia,51065,Fluvanna County,8071,7289,15620,782,0.5167093469910371,0.46664532650448143,0.05006402048655567
Virginia,51067,Franklin County,20797,8312,29459,12485,0.7059642214603347,0.2821548592959707,0.423809362164364
Virginia,51069,Frederick County,30126,16021,46918,14105,0.6420989812012448,0.3414680932691078,0.30063088793213694
Virginia,51071,Giles County,6876,2156,9157,4720,0.7509009500928252,0.23544829092497543,0.5154526591678498
Virginia,51073,Gloucester County,14875,6964,22228,7911,0.6692010077379881,0.31329854237898147,0.3559024653590066
Virginia,51075,Goochland County,9896,6623,16759,3273,0.5904886926427592,0.39519064383316427,0.1952980488095949
Virginia,51077,Grayson County,6529,1535,8120,4994,0.804064039408867,0.18903940886699508,0.6150246305418718
Virginia,51079,Greene County,6819,4089,11144,2730,0.6118987796123474,0.3669239052404882,0.24497487437185922
Virginia,51081,Greensville County,1914,2627,4565,-713,0.41927710843373495,0.5754654983570646,-0.15618838992332967
Virginia,51083,Halifax County,10404,7648,18192,2756,0.5718997361477572,0.4204045734388742,0.15149516270888302
Virginia,51085,Hanover County,44318,25307,70728,19011,0.6265976699468386,0.35780737473136526,0.2687902952154734
Virginia,51087,Henrico County,61280,110115,173610,-48835,0.35297505904037785,0.6342664593053395,-0.2812914002649617
Virginia,51089,Henry County,16725,9127,26075,7598,0.6414189837008629,0.3500287631831256,0.29139022051773733
Virginia,51091,Highland County,1092,417,1531,675,0.713259307642064,0.2723709993468321,0.4408883082952319
Virginia,51093,Isle of Wight County,13661,9346,23330,4315,0.5855550792970424,0.4006000857265324,0.18495499357051004
Virginia,51095,James City County,23059,25374,49314,-2315,0.4675954090116397,0.51453948168877,-0.046944072677130244
Virginia,51097,King and Queen County,2450,1590,4104,860,0.5969785575048733,0.38742690058479534,0.20955165692007793
Virginia,51099,King George County,8446,5404,14164,3042,0.59630048009037,0.3815306410618469,0.21476983902852304
Virginia,51101,King William County,7320,3260,10733,4060,0.6820087580359638,0.3037361408739402,0.37827261716202365
Virginia,51103,Lancaster County,3694,3361,7126,333,0.5183833847880999,0.4716531013191131,0.04673028346898678
Virginia,51105,Lee County,8365,1489,9932,6876,0.8422271445831655,0.1499194522754732,0.6923076923076923
Virginia,51107,Loudoun County,81837,137827,224036,-55990,0.3652850434751558,0.6152002356764091,-0.24991519220125336
Virginia,51109,Louisa County,13294,8269,21914,5025,0.6066441544218308,0.37733868759697,0.22930546682486086
Virginia,51111,Lunenburg County,3586,2413,6038,1173,0.5939052666445843,0.39963564094070886,0.19426962570387546
Virginia,51113,Madison County,5294,2684,8108,2610,0.6529353724716329,0.33103108041440554,0.32190429205722737
Virginia,51115,Mathews County,3900,1824,5824,2076,0.6696428571428571,0.3131868131868132,0.3564560439560439
Virginia,51117,Mecklenburg County,9266,6803,16182,2463,0.5726115436905204,0.4204053887034977,0.15220615498702267
Virginia,51119,Middlesex County,4196,2491,6764,1705,0.6203429923122413,0.36827321111768185,0.2520697811945595
Virginia,51121,Montgomery County,20573,23077,44573,-2504,0.46155744509007696,0.5177349516523456,-0.056177506562268664
Virginia,51125,Nelson County,4799,4307,9335,492,0.5140867702196037,0.4613818960899839,0.05270487412961977
Virginia,51127,New Kent County,8929,3162,12224,5767,0.7304482984293194,0.25867146596858637,0.471776832460733
Virginia,51131,Northampton County,2955,3667,6722,-712,0.43960130913418627,0.5455221660220173,-0.10592085688783104
Virginia,51133,Northumberland County,4477,3240,7772,1237,0.5760422027792074,0.4168811116829645,0.15916109109624288
Virginia,51135,Nottoway County,4032,2976,7080,1056,0.5694915254237288,0.42033898305084744,0.1491525423728814
Virginia,51137,Orange County,12426,7995,20688,4431,0.6006380510440835,0.38645591647331784,0.21418213457076568
Virginia,51139,Page County,9316,2982,12432,6334,0.7493564993564994,0.23986486486486486,0.5094916344916345
Virginia,51141,Patrick County,7474,1948,9527,5526,0.7845071900913194,0.20447150204681433,0.5800356880445051
Virginia,51143,Pittsylvania County,23704,10053,34041,13651,0.696336770365148,0.2953203489909227,0.4010164213742253
Virginia,51145,Powhatan County,14055,5320,19730,8735,0.7123669538773442,0.26964014191586416,0.44272681196148
Virginia,51147,Prince Edward County,4434,4973,9543,-539,0.46463376296762027,0.5211149533689615,-0.05648119040134125
Virginia,51149,Prince George County,10106,6870,17182,3236,0.588173670119893,0.39983703876149457,0.1883366313583984
Virginia,51153,Prince William County,76432,139502,219075,-63070,0.34888508501654686,0.6367773593518201,-0.28789227433527326
Virginia,51155,Pulaski County,12127,4925,17376,7202,0.6979166666666666,0.28343692449355434,0.4144797421731123
Virginia,51157,Rappahannock County,2815,2096,4967,719,0.5667404872156231,0.4219851016710288,0.14475538554459427
Virginia,51159,Richmond County,2547,1513,4091,1034,0.6225861647518944,0.3698362258616475,0.25274993889024694
Virginia,51161,Roanoke County,33758,21218,55845,12540,0.6044945832214165,0.3799444892112096,0.22455009401020687
Virginia,51163,Rockbridge County,8047,4022,12368,4025,0.650630659767141,0.3251940491591203,0.32543661060802065
Virginia,51165,Rockingham County,28608,9311,38622,19297,0.7407177256485941,0.2410802133499042,0.49963751229868986
Virginia,51167,Russell County,10879,2373,13368,8506,0.8138090963494913,0.17751346499102333,0.636295631358468
Virginia,51169,Scott County,9063,1692,10845,7371,0.8356846473029046,0.15601659751037344,0.6796680497925311
Virginia,51171,Shenandoah County,16398,6781,23522,9617,0.6971345973981804,0.28828330924241136,0.40885128815576904
Virginia,51173,Smyth County,10941,2989,14057,7952,0.7783310806004126,0.21263427473856442,0.5656968058618481
Virginia,51175,Southampton County,5730,3969,9786,1761,0.5855303494788473,0.4055793991416309,0.17995095033721642
Virginia,51177,Spotsylvania County,39506,34385,75302,5121,0.5246341398634831,0.4566279780085522,0.06800616185493086
Virginia,51179,Stafford County,37513,40138,79021,-2625,0.4747219093658648,0.5079409270953291,-0.03321901772946434
Virginia,51181,Surry County,2025,2397,4462,-372,0.45383236216943074,0.5372030479605558,-0.08337068579112511
Virginia,51183,Sussex County,2217,2822,5081,-605,0.4363314308207046,0.5554024798268058,-0.11907104900610122
Virginia,51185,Tazewell County,16665,3169,19989,13496,0.8337085396968332,0.15853719545750164,0.6751713442393316
Virginia,51187,Warren County,14033,6564,20959,7469,0.6695453027339091,0.31318288086263657,0.35636242187127254
Virginia,51191,Washington County,21678,6617,28684,15061,0.75575233579696,0.23068609677869195,0.5250662390182681
Virginia,51193,Westmoreland County,5286,4453,9853,833,0.5364863493352279,0.45194357048614636,0.08454277884908151
Virginia,51195,Wise County,13315,3084,16505,10231,0.8067252347773401,0.1868524689488034,0.6198727658285368
Virginia,51197,Wythe County,11733,3143,15046,8590,0.7798085869998671,0.20889272896450883,0.5709158580353583
Virginia,51199,York County,20087,17410,38165,2677,0.5263199266343509,0.4561771256386742,0.07014280099567671
Virginia,51510,Alexandria city,14251,65201,80425,-50950,0.17719614547715262,0.8107056263599627,-0.6335094808828101
Virginia,51520,Bristol city,5347,2313,7802,3034,0.6853370930530633,0.296462445526788,0.3888746475262753
Virginia,51530,Buena Vista city,1863,825,2815,1038,0.6618117229129663,0.29307282415630553,0.36873889875666077
Virginia,51540,Charlottesville city,3094,20696,24101,-17602,0.12837641591635202,0.8587195552051782,-0.7303431392888262
Virginia,51550,Chesapeake city,57651,65330,125009,-7679,0.46117479541473017,0.5226023726291708,-0.06142757721444059
Virginia,51570,Colonial Heights city,6007,2972,9114,3035,0.6590958964230854,0.326091727013386,0.3330041694096994
Virginia,51580,Covington city,1580,964,2594,616,0.6090979182729376,0.37162683114880496,0.23747108712413262
Virginia,51590,Danville city,7396,11615,19204,-4219,0.3851280983128515,0.6048219121016455,-0.219693813788794
Virginia,51595,Emporia city,754,1612,2379,-858,0.31693989071038253,0.6775956284153005,-0.360655737704918
Virginia,51600,Fairfax city,3982,9120,13303,-5138,0.2993309779748929,0.6855596481996542,-0.3862286702247613
Virginia,51610,Falls Church city,1490,7146,8750,-5656,0.1702857142857143,0.8166857142857142,-0.6464
Virginia,51620,Franklin city,1482,2505,4031,-1023,0.36765070702059044,0.6214338873728603,-0.2537831803522699
Virginia,51630,Fredericksburg city,4037,8517,12794,-4480,0.3155385336876661,0.6657026731280288,-0.3501641394403627
Virginia,51640,Galax city,1836,775,2629,1061,0.698364397109167,0.29478889311525297,0.403575503993914
Virginia,51650,Hampton city,18201,45481,64654,-27280,0.28151390478547345,0.7034522226003032,-0.4219383178148297
Virginia,51660,Harrisonburg city,5560,10935,16851,-5375,0.3299507447629221,0.6489229125867901,-0.31897216782386806
Virginia,51670,Hopewell city,4018,5427,9630,-1409,0.41723779854620974,0.5635514018691589,-0.14631360332294913
Virginia,51678,Lexington city,901,1782,2731,-881,0.32991578176492126,0.6525082387403881,-0.32259245697546685
Virginia,51680,Lynchburg city,16697,17447,35866,-750,0.46553839290693133,0.4864495622595216,-0.020911169352590242
Virginia,51683,Manassas city,6182,10100,16555,-3918,0.373421926910299,0.6100875868317729,-0.23666565992147387
Virginia,51685,Manassas Park city,2062,3913,6071,-1851,0.3396475045297315,0.6445396145610278,-0.3048921100312963
Virginia,51690,Martinsville city,2165,3766,6004,-1601,0.3605929380413058,0.6272485009993338,-0.266655562958028
Virginia,51700,Newport News city,25594,50319,77859,-24725,0.3287224341437727,0.6462836666281355,-0.3175612324843628
Virginia,51710,Norfolk city,22038,59396,83041,-37358,0.2653869775171301,0.7152611360653172,-0.4498741585481871
Virginia,51720,Norton city,1112,464,1597,648,0.6963055729492799,0.2905447714464621,0.40576080150281774
Virginia,51730,Petersburg city,1573,12293,13973,-10720,0.11257425033994131,0.8797681242396049,-0.7671938738996636
Virginia,51735,Poquoson city,5605,2054,7819,3551,0.7168435861363346,0.2626934390587032,0.4541501470776314
Virginia,51740,Portsmouth city,12755,30948,44576,-18193,0.2861405240488155,0.6942749461593682,-0.40813442211055273
Virginia,51750,Radford city,2786,3358,6289,-572,0.4429957067896327,0.5339481634600095,-0.09095245667037682
Virginia,51760,Richmond city,15707,86460,103917,-70753,0.1511494750618282,0.8320101619561766,-0.6808606868943484
Virginia,51770,Roanoke city,15356,25929,42033,-10573,0.3653320010467966,0.6168724573549355,-0.25154045630813887
Virginia,51775,Salem city,7683,5148,13051,2535,0.5886905217990959,0.3944525323729982,0.19423798942609766
Virginia,51790,Staunton city,5642,6886,12781,-1244,0.4414365073155465,0.5387684844691338,-0.09733197715358732
Virginia,51800,Suffolk city,20006,28484,49213,-8478,0.40651860280820107,0.5787901570723183,-0.17227155426411722
Virginia,51810,Virginia Beach city,115107,134252,253477,-19145,0.4541122074192136,0.5296417426433168,-0.07552953522410316
Virginia,51820,Waynesboro city,5474,4918,10638,556,0.5145704079714232,0.46230494453844706,0.05226546343297611
Virginia,51830,Williamsburg city,1963,4790,6845,-2827,0.2867786705624543,0.6997808619430241,-0.4130021913805698
Virginia,51840,Winchester city,5156,6451,11812,-1295,0.4365052488994243,0.546139519133085,-0.10963427023366068
Washington,53001,Adams County,3449,1562,5109,1887,0.6750831865335682,0.30573497749070266,0.3693482090428656
Washington,53003,Asotin County,7259,4233,11847,3026,0.6127289609183759,0.35730564699924033,0.2554233139191356
Washington,53005,Benton County,59588,37859,101066,21729,0.5895949181722835,0.3745967981319138,0.21499812004036967
Washington,53007,Chelan County,22476,19005,42548,3471,0.5282504465544796,0.44667199398326596,0.08157845257121366
Washington,53009,Clallam County,20131,22535,43697,-2404,0.46069524223630914,0.5157104606723574,-0.05501521843604823
Washington,53011,Clark County,124756,138612,270039,-13856,0.4619925270053585,0.5133036339195449,-0.051311106914186444
Washington,53013,Columbia County,1699,644,2397,1055,0.7088026700041719,0.2686691697955778,0.44013350020859404
Washington,53015,Cowlitz County,33976,23631,59164,10345,0.5742681360286661,0.3994151849097424,0.17485295111892368
Washington,53017,Douglas County,12619,7554,20567,5065,0.6135556960178927,0.36728740214907374,0.246268293868819
Washington,53019,Ferry County,2735,1465,4308,1270,0.6348653667595172,0.3400649953574745,0.29480037140204274
Washington,53021,Franklin County,17583,12786,31330,4797,0.5612192786466645,0.4081072454516438,0.15311203319502076
Washington,53023,Garfield County,1062,362,1478,700,0.7185385656292287,0.2449255751014885,0.4736129905277402
Washington,53025,Grant County,16662,8386,25575,8276,0.6514956011730205,0.32789833822091885,0.32359726295210167
Washington,53027,Grays Harbor County,18960,16623,36652,2337,0.5172978282221979,0.45353595983848083,0.06376186838371711
Washington,53029,Island County,22535,29003,53089,-6468,0.42447588012582643,0.5463090282356043,-0.12183314810977791
Washington,53031,Jefferson County,6531,16578,23580,-10047,0.27697201017811707,0.7030534351145038,-0.42608142493638673
Washington,53033,King County,262428,891510,1178868,-629082,0.2226101650057513,0.7562424291778215,-0.5336322641720702
Washington,53035,Kitsap County,60838,89373,155853,-28535,0.390355014019621,0.5734442070412504,-0.1830891930216294
Washington,53037,Kittitas County,13778,11004,25579,2774,0.5386449822119708,0.4301966456859142,0.10844833652605657
Washington,53039,Klickitat County,6203,5216,11621,987,0.533775062387058,0.44884261251183205,0.08493244987522591
Washington,53041,Lewis County,29074,14316,44735,14758,0.649916173018889,0.3200178830893037,0.32989828992958536
Washington,53043,Lincoln County,5095,1694,6942,3401,0.7339383462978969,0.24402189570728897,0.48991645059060795
Washington,53045,Mason County,18342,16999,36572,1343,0.5015312260745926,0.46480914360713116,0.03672208246746139
Washington,53047,Okanogan County,9231,7469,16985,1762,0.5434795407712688,0.43974094789520163,0.10373859287606718
Washington,53049,Pacific County,6930,6776,14011,154,0.49461137677539074,0.48362001284704875,0.01099136392834199
Washington,53051,Pend Oreille County,5655,2578,8422,3077,0.6714557112324864,0.3061030634053669,0.36535264782711946
Washington,53053,Pierce County,193795,244893,453965,-51098,0.42689414382166024,0.5394534820966375,-0.11255933827497722
Washington,53055,San Juan County,2994,9606,12977,-6612,0.23071588194497958,0.740232719426678,-0.5095168374816984
Washington,53057,Skagit County,19598,26753,47259,-7155,0.41469349753486107,0.5660932309189783,-0.15139973338411727
Washington,53059,Skamania County,3694,3016,6918,678,0.5339693553050014,0.43596415148886963,0.09800520381613181
Washington,53061,Snohomish County,162972,251625,428889,-88653,0.379986430055329,0.5866902625154761,-0.20670383246014706
Washington,53063,Spokane County,146805,133892,291049,12913,0.5043996028160207,0.4600325031180317,0.04436709969798902
Washington,53065,Stevens County,14566,6563,21581,8003,0.6749455539595014,0.3041100968444465,0.3708354571150549
Washington,53067,Thurston County,58200,89778,152918,-31578,0.38059613649145296,0.5870989680743928,-0.2065028315829398
Washington,53069,Wahkiakum County,1711,1150,2931,561,0.5837598089389286,0.39235755714773113,0.19140225179119752
Washington,53071,Walla Walla County,12068,10705,23379,1363,0.5161897429316908,0.4578895590059455,0.05830018392574532
Washington,53073,Whatcom County,50041,82809,137032,-32768,0.36517747679374163,0.6043041041508552,-0.2391266273571136
Washington,53075,Whitman County,7245,8794,16653,-1549,0.43505674653215637,0.5280730198762985,-0.09301627334414214
Washington,53077,Yakima County,35017,28967,65221,6050,0.5368976249980835,0.44413609113629043,0.09276153386179303
West Virginia,54001,Barbour County,5094,1438,6634,3656,0.7678625263792583,0.21676213445884834,0.55110039192041
West Virginia,54003,Berkeley County,32062,16075,49146,15987,0.6523826964554592,0.32708663980791924,0.32529605664753997
West Virginia,54005,Boone County,6775,2029,8983,4746,0.7542023822776356,0.22587108983635756,0.528331292441278
West Virginia,54007,Braxton County,4115,1453,5650,2662,0.7283185840707964,0.25716814159292034,0.4711504424778761
West Virginia,54009,Brooke County,7516,2936,10631,4580,0.7069889944501928,0.27617345499012325,0.43081553946006956
West Virginia,54011,Cabell County,21440,14733,36795,6707,0.582687865199076,0.4004076640847941,0.1822802011142819
West Virginia,54013,Calhoun County,2346,563,2948,1783,0.7957937584803256,0.19097693351424694,0.6048168249660787
West Virginia,54015,Clay County,2661,640,3346,2021,0.7952779438135087,0.19127316198445907,0.6040047818290496
West Virginia,54017,Doddridge County,2592,432,3069,2160,0.844574780058651,0.14076246334310852,0.7038123167155426
West Virginia,54019,Fayette County,11514,5031,16794,6483,0.6856020007145409,0.2995712754555198,0.3860307252590211
West Virginia,54021,Gilmer County,1997,591,2639,1406,0.7567260325881016,0.22394846532777568,0.5327775672603259
West Virginia,54023,Grant County,4861,605,5497,4256,0.8843005275604875,0.1100600327451337,0.7742404948153538
West Virginia,54025,Greenbrier County,10898,4641,15827,6257,0.6885701649080684,0.2932330827067669,0.39533708220130154
West Virginia,54027,Hampshire County,7829,1919,9872,5910,0.7930510534846029,0.19438816855753646,0.5986628849270664
West Virginia,54029,Hancock County,9653,3670,13546,5983,0.7126088882326886,0.27092868743540527,0.4416802007972834
West Virginia,54031,Hardy County,4827,1371,6287,3456,0.7677747733418164,0.21806903133449976,0.5497057420073167
West Virginia,54033,Harrison County,20581,9149,30375,11432,0.6775637860082304,0.30120164609053496,0.37636213991769546
West Virginia,54035,Jackson County,10025,3197,13429,6828,0.7465187281256981,0.23806687020627001,0.508451857919428
West Virginia,54037,Jefferson County,14813,11831,27163,2982,0.5453374075028532,0.4355557191768214,0.1097816883260318
West Virginia,54039,Kanawha County,46086,34139,82001,11947,0.5620175363715076,0.41632419116840036,0.14569334520310728
West Virginia,54041,Lewis County,5759,1531,7423,4228,0.7758318739054291,0.20625084197763707,0.569581031927792
West Virginia,54043,Lincoln County,5967,1703,7775,4264,0.767459807073955,0.2190353697749196,0.5484244372990354
West Virginia,54045,Logan County,10501,2325,12981,8176,0.8089515445651336,0.1791079269701872,0.6298436175949464
West Virginia,54047,McDowell County,5125,1323,6494,3802,0.7891900215583616,0.20372651678472437,0.5854635047736372
West Virginia,54049,Marion County,16218,8836,25704,7382,0.6309523809523809,0.3437597261126673,0.2871926548397136
West Virginia,54051,Marshall County,10137,3348,13666,6789,0.7417678911166399,0.24498756036879848,0.4967803307478414
West Virginia,54053,Mason County,8422,2511,11149,5911,0.755404072114091,0.22522199300385684,0.5301820791102342
West Virginia,54055,Mercer County,19185,5522,25103,13663,0.7642512847070071,0.21997370832171453,0.5442775763852925
West Virginia,54057,Mineral County,9904,2579,12652,7325,0.7828011381599747,0.203841289914638,0.5789598482453366
West Virginia,54059,Mingo County,8521,1385,9987,7136,0.8532091719235005,0.13868028436968058,0.7145288875538199
West Virginia,54061,Monongalia County,20656,20064,41873,592,0.4933011725933179,0.4791631839132615,0.01413798868005639
West Virginia,54063,Monroe County,5012,1330,6417,3682,0.78105033504753,0.20726196041764064,0.5737883746298893
West Virginia,54065,Morgan County,6157,1945,8257,4212,0.7456703403173065,0.23555770861087563,0.5101126317064308
West Virginia,54067,Nicholas County,8221,2206,10570,6015,0.777767265846736,0.2087038789025544,0.5690633869441817
West Virginia,54069,Ohio County,12226,7139,19674,5087,0.621429297550066,0.3628646945206872,0.25856460302937884
West Virginia,54071,Pendleton County,2764,816,3646,1948,0.7580910586944597,0.2238069116840373,0.5342841470104224
West Virginia,54073,Pleasants County,2726,692,3467,2034,0.7862705509085665,0.19959619267378137,0.5866743582347851
West Virginia,54075,Pocahontas County,2876,1039,3979,1837,0.7227946720281477,0.261120884644383,0.46167378738376474
West Virginia,54077,Preston County,11143,3147,14508,7996,0.7680590019299697,0.21691480562448304,0.5511441963054866
West Virginia,54079,Putnam County,19921,7824,28410,12097,0.7011967617036254,0.2753959873284055,0.42580077437521996
West Virginia,54081,Raleigh County,24297,7841,32640,16456,0.7443933823529412,0.24022671568627452,0.5041666666666667
West Virginia,54083,Randolph County,8655,3353,12172,5302,0.7110581662832731,0.2754682878738087,0.4355898784094644
West Virginia,54085,Ritchie County,3637,585,4269,3052,0.8519559615835091,0.13703443429374562,0.7149215272897634
West Virginia,54087,Roane County,4199,1451,5745,2748,0.7308964316797215,0.2525674499564839,0.4783289817232376
West Virginia,54089,Summers County,4068,1444,5583,2624,0.7286405158516926,0.2586423070034032,0.46999820884828947
West Virginia,54091,Taylor County,5439,1787,7334,3652,0.7416143986910281,0.24365966730297245,0.4979547313880556
West Virginia,54093,Tucker County,2833,933,3830,1900,0.739686684073107,0.24360313315926893,0.49608355091383805
West Virginia,54095,Tyler County,3183,626,3873,2557,0.8218435321456236,0.16163180996643428,0.6602117221791892
West Virginia,54097,Upshur County,7721,2247,10161,5474,0.7598661549060132,0.2211396516090936,0.5387265032969195
West Virginia,54099,Wayne County,12462,3964,16735,8498,0.744666865850015,0.23686883776516282,0.5077980280848522
West Virginia,54101,Webster County,2737,608,3378,2129,0.8102427471876851,0.17998815867377146,0.6302545885139136
West Virginia,54103,Wetzel County,4933,1529,6596,3404,0.7478775015160704,0.23180715585203154,0.5160703456640388
West Virginia,54105,Wirt County,2103,461,2617,1642,0.803591899121131,0.1761559037065342,0.6274359954145968
West Virginia,54107,Wood County,77201,37507,116703,39694,0.661516841897809,0.3213884818727882,0.34012836002502084
West Virginia,54109,Wyoming County,7254,1149,8485,6105,0.8549204478491456,0.13541543901001768,0.7195050088391279
Wisconsin,55001,Adams County,7362,4329,11808,3033,0.6234756097560976,0.3666158536585366,0.256859756097561
Wisconsin,55003,Ashland County,3845,4794,8744,-949,0.43973010064043916,0.5482616651418115,-0.10853156450137236
Wisconsin,55005,Barron County,15803,9194,25345,6609,0.6235154862892089,0.3627539948707832,0.26076149141842575
Wisconsin,55007,Bayfield County,4617,6155,10885,-1538,0.42416169039963253,0.5654570509875976,-0.14129536058796505
Wisconsin,55009,Brown County,75865,65509,144011,10356,0.5268000361083528,0.4548888626563249,0.07191117345202791
Wisconsin,55011,Buffalo County,4834,2859,7811,1975,0.618870823198054,0.3660222762770452,0.2528485469210088
Wisconsin,55013,Burnett County,6461,3569,10141,2892,0.6371166551622128,0.3519376787299083,0.28517897643230455
Wisconsin,55015,Calumet County,18142,12115,30858,6027,0.5879188541059045,0.39260483505087823,0.19531401905502627
Wisconsin,55017,Chippewa County,21316,14001,35945,7315,0.5930171094728057,0.3895117540687161,0.20350535540408965
Wisconsin,55019,Clark County,10001,4520,14873,5481,0.672426544745512,0.303906407584213,0.368520137161299
Wisconsin,55021,Columbia County,16925,16408,33917,517,0.49901229471946223,0.48376920128549106,0.015243093433971178
Wisconsin,55023,Crawford County,4620,3953,8698,667,0.5311565877213152,0.4544722924810301,0.07668429524028514
Wisconsin,55025,Dane County,78789,260157,344745,-181368,0.2285428360092242,0.7546360353304616,-0.5260931993212374
Wisconsin,55027,Dodge County,31354,16355,48497,14999,0.6465142173742706,0.3372373548879312,0.3092768624863394
Wisconsin,55029,Door County,9752,10044,20117,-292,0.4847641298404335,0.4992792165829895,-0.014515086742556027
Wisconsin,55031,Douglas County,10919,13214,24668,-2295,0.4426382357710394,0.5356737473650073,-0.09303551159396789
Wisconsin,55033,Dunn County,13176,9909,23543,3267,0.55965679819904,0.4208894363505076,0.13876736184853244
Wisconsin,55035,Eau Claire County,25339,31617,58235,-6278,0.43511633897140894,0.5429209238430497,-0.10780458487164074
Wisconsin,55037,Florence County,2133,781,2939,1352,0.7257570602245662,0.26573664511738687,0.46002041510717934
Wisconsin,55039,Fond du Lac County,35754,20588,57322,15166,0.6237395764278986,0.3591640207948083,0.26457555563309026
Wisconsin,55041,Forest County,3287,1722,5052,1565,0.650633412509897,0.34085510688836107,0.30977830562153597
Wisconsin,55043,Grant County,13981,10942,25379,3039,0.5508885298869144,0.4311438590961031,0.1197446707908113
Wisconsin,55045,Green County,10165,10850,21400,-685,0.475,0.5070093457943925,-0.03200934579439252
Wisconsin,55047,Green Lake County,7165,3344,10663,3821,0.6719497327206227,0.313607802682172,0.3583419300384508
Wisconsin,55049,Iowa County,5907,7828,13984,-1921,0.4224113272311213,0.5597826086956522,-0.13737128146453093
Wisconsin,55051,Iron County,2439,1533,4031,906,0.6050607789630364,0.3803026544281816,0.22475812453485483
Wisconsin,55053,Jackson County,5789,4255,10187,1534,0.5682732894866006,0.41768921174045354,0.15058407774614707
Wisconsin,55055,Jefferson County,27209,19904,47967,7305,0.5672441470177414,0.41495194612963077,0.15229220088811063
Wisconsin,55057,Juneau County,8749,4747,13702,4002,0.6385199240986718,0.34644577433951246,0.2920741497591593
Wisconsin,55059,Kenosha County,44972,42191,88691,2781,0.5070638508980618,0.4757077944774554,0.031356056420606404
Wisconsin,55061,Kewaunee County,7927,3977,12071,3950,0.6566978709303289,0.32946731836633253,0.3272305525639964
Wisconsin,55063,La Crosse County,28683,37843,67848,-9160,0.42275380261761586,0.5577614668081594,-0.13500766419054355
Wisconsin,55065,Lafayette County,4820,3647,8557,1173,0.5632815238985626,0.4262007712983522,0.13708075260021035
Wisconsin,55067,Langlade County,7330,3703,11159,3627,0.6568688950622815,0.33183977058876246,0.32502912447351906
Wisconsin,55069,Lincoln County,10017,6260,16531,3757,0.6059524529671526,0.3786824753493437,0.22726997761780893
Wisconsin,55071,Manitowoc County,27217,16817,44808,10400,0.6074138546688092,0.3753124442063917,0.23210141046241745
Wisconsin,55073,Marathon County,44623,30807,76741,13816,0.5814753521585593,0.40144121134725896,0.18003414081130031
Wisconsin,55075,Marinette County,15303,7363,22977,7940,0.6660138399268835,0.32045088566827695,0.3455629542586065
Wisconsin,55077,Marquette County,5719,3239,9060,2480,0.6312362030905078,0.35750551876379694,0.2737306843267108
Wisconsin,55078,Menominee County,278,1303,1586,-1025,0.17528373266078184,0.8215636822194199,-0.646279949558638
Wisconsin,55079,Milwaukee County,134355,317251,458935,-182896,0.2927538758211947,0.6912765424297559,-0.39852266660856117
Wisconsin,55081,Monroe County,13775,8432,22564,5343,0.6104857294805885,0.37369260769367135,0.2367931217869172
Wisconsin,55083,Oconto County,16226,6715,23214,9511,0.6989747566123891,0.289265098647368,0.40970965796502107
Wisconsin,55085,Oneida County,13671,10105,24159,3566,0.56587607102943,0.418270623784097,0.14760544724533303
Wisconsin,55087,Outagamie County,58379,47659,108223,10720,0.5394324681444794,0.4403777385583471,0.09905472958613232
Wisconsin,55089,Ozaukee County,33912,26515,61453,7397,0.5518363627487674,0.4314679511171139,0.12036841163165346
Wisconsin,55091,Pepin County,2584,1489,4140,1095,0.6241545893719807,0.3596618357487923,0.26449275362318836
Wisconsin,55093,Pierce County,12813,9789,23336,3024,0.549065821049023,0.41948063078505315,0.12958519026396986
Wisconsin,55095,Polk County,16590,9361,26326,7229,0.6301754919091392,0.3555800349464408,0.27459545696269844
Wisconsin,55097,Portage County,19298,20426,40601,-1128,0.4753084899386715,0.5030910568705205,-0.027782566931848995
Wisconsin,55099,Price County,5394,3132,8645,2262,0.6239444765760556,0.36229034123770965,0.2616541353383459
Wisconsin,55101,Racine County,54475,50154,106441,4321,0.5117858719854191,0.4711906126398662,0.040595259345552914
Wisconsin,55103,Richland County,4877,3995,9016,882,0.540927240461402,0.4431011535048802,0.09782608695652173
Wisconsin,55105,Rock County,37133,46649,85348,-9516,0.4350775647935511,0.5465740263392229,-0.11149646154567183
Wisconsin,55107,Rusk County,5257,2517,7881,2740,0.66704732901916,0.3193757137419109,0.34767161527724905
Wisconsin,55109,St. Croix County,32190,23190,56701,9000,0.5677148551171937,0.40898749581136135,0.15872735930583232
Wisconsin,55111,Sauk County,17489,18103,36249,-614,0.4824684818891556,0.49940688018979834,-0.016938398300642754
Wisconsin,55113,Sawyer County,5883,4494,10479,1389,0.5614085313484111,0.4288577154308617,0.13255081591754936
Wisconsin,55115,Shawano County,15447,7131,22878,8316,0.6751901389981642,0.3116968266456858,0.36349331235247834
Wisconsin,55117,Sheboygan County,37624,27109,66020,10515,0.569887912753711,0.41061799454710696,0.15926991820660402
Wisconsin,55119,Taylor County,7656,2693,10683,4963,0.7166526256669475,0.25208274829167837,0.46456987737526917
Wisconsin,55121,Trempealeau County,8828,6283,15356,2545,0.5748892940870018,0.4091560302162021,0.16573326387079973
Wisconsin,55123,Vernon County,8216,7457,15910,759,0.5164047768698932,0.46869893148962916,0.04770584538026401
Wisconsin,55125,Vilas County,9261,5903,15338,3358,0.6037944973269005,0.38486112922154125,0.21893336810535924
Wisconsin,55127,Walworth County,33844,22783,57588,11061,0.5876918802528305,0.39562061540598736,0.19207126484684311
Wisconsin,55129,Washburn County,6332,3867,10371,2465,0.6105486452608234,0.3728666473821232,0.2376819978787002
Wisconsin,55131,Washington County,60235,26647,88254,33588,0.6825186393817844,0.3019353230448478,0.38058331633693654
Wisconsin,55133,Waukesha County,159633,103867,267957,55766,0.5957411077150438,0.3876256264997742,0.20811548121526963
Wisconsin,55135,Waupaca County,18948,9699,29118,9249,0.6507315062847723,0.33309293220688235,0.3176385740778899
Wisconsin,55137,Waushara County,9016,4388,13564,4628,0.6647006782659982,0.3235033913299912,0.34119728693600704
Wisconsin,55139,Winnebago County,47795,44060,94032,3735,0.5082844138165731,0.4685638931427599,0.03972052067381315
Wisconsin,55141,Wood County,24307,16360,41197,7947,0.5900186906813603,0.3971162948758405,0.19290239580551977
Wyoming,56001,Albany County,8575,9091,18612,-516,0.4607242639157533,0.488448312916398,-0.027724049000644735
Wyoming,56003,Big Horn County,4806,788,5752,4018,0.8355354659248957,0.13699582753824757,0.6985396383866481
Wyoming,56005,Campbell County,16973,1935,19564,15038,0.8675628705786138,0.09890615416070334,0.7686567164179104
Wyoming,56007,Carbon County,5012,1427,6662,3585,0.7523266286400481,0.21419993995797057,0.5381266886820775
Wyoming,56009,Converse County,5916,861,6969,5055,0.848902281532501,0.12354713732242789,0.7253551442100732
Wyoming,56011,Crook County,3651,378,4119,3273,0.8863801893663511,0.09176984705025491,0.7946103423160962
Wyoming,56013,Fremont County,12007,5519,18111,6488,0.6629672574678372,0.3047319308707415,0.3582353265970957
Wyoming,56015,Goshen County,4878,1203,6241,3675,0.7816055119371895,0.19275757090209902,0.5888479410350905
Wyoming,56017,Hot Springs County,1999,482,2577,1517,0.775708187815289,0.18703919285991463,0.5886689949553744
Wyoming,56019,Johnson County,3881,897,4914,2984,0.7897842897842898,0.18253968253968253,0.6072446072446073
Wyoming,56021,Laramie County,27814,15181,44865,12633,0.6199487350941714,0.33837066755823025,0.2815780675359411
Wyoming,56023,Lincoln County,8673,1509,10498,7164,0.8261573633072966,0.1437416650790627,0.6824156982282339
Wyoming,56025,Natrona County,25267,8528,35196,16739,0.7178940788725992,0.24230026139334016,0.475593817479259
Wyoming,56027,Niobrara County,1118,155,1308,963,0.8547400611620795,0.11850152905198777,0.7362385321100917
Wyoming,56029,Park County,12802,3404,16699,9398,0.766632732498952,0.20384454158931672,0.5627881909096353
Wyoming,56031,Platte County,3898,890,4923,3008,0.7917936217753403,0.18078407475116798,0.6110095470241723
Wyoming,56033,Sheridan County,11843,4043,16428,7800,0.7209033357682006,0.24610421232042853,0.4747991234477721
Wyoming,56035,Sublette County,3957,882,4970,3075,0.7961770623742455,0.17746478873239438,0.6187122736418511
Wyoming,56037,Sweetwater County,12197,3822,16489,8375,0.7397052580508218,0.23179089089696162,0.5079143671538602
Wyoming,56039,Teton County,4341,9848,14677,-5507,0.2957688901001567,0.6709818082714452,-0.37521291817128843
Wyoming,56041,Uinta County,7494,1591,9400,5903,0.7972340425531915,0.16925531914893616,0.6279787234042553
Wyoming,56043,Washakie County,3245,651,4012,2594,0.8088235294117647,0.16226321036889332,0.6465603190428714
Wyoming,56045,Weston County,3107,360,3542,2747,0.8771880293619424,0.10163749294184077,0.7755505364201016